刘粤军|liú yuè jūn
胡平|hú píng
朝河蘭|zhāo hé lán
兽欲|shòu yù
国统会|guó tǒng huì
择民|zé mín
连战|lián zhàn
简易原子弹教程|jiǎn yì yuán zǐ dàn jiào chéng
北美论坛|běi měi lùn tán
省委大门集合|shěng wěi dà mén jí hé
集体抗议|jí tǐ kàng yì
代办各|dài bàn gè
媒体封锁|méi tǐ fēng suǒ
俄羅斯|é luó sī
梁光烈|liáng guāng liè
弓弩专营|gōng nǔ zhuān yíng
各类军用枪|gè lèi jūn yòng qiāng
伐沦|fá lún
联总之声|lián zǒng zhī shēng
江系人|jiāng xì rén
麻古|má gǔ
台湾政论区|tái wān zhèng lùn qū
乳交|rǔ jiāo
针刺案|zhēn cì àn
找女|zhǎo nǚ
零八奥运艰|líng bā ào yùn jiān
瘟疫爆发|wēn yì bào fā
视频来源|shì pín lái yuán
号码百事通|hào mǎ bǎi shì tōng
舞女|wǔ nǚ
十八年|shí bā nián
毛泽东侄子|máo zé dōng zhí zǐ
四大扯个|sì dà chě gè
平叫到床|píng jiào dào chuáng
政付|zhèng fù
刘永清|liú yǒng qīng
马晓天|mǎ xiǎo tiān
《中国民主》|《zhōng guó mín zhǔ 》
伐伦|fá lún
和狗做|hé gǒu zuò
少女迷情药|shǎo nǚ mí qíng yào
告全国同胞书|gào quán guó tóng bāo shū
流淫|liú yín
东西南北论坛|dōng xī nán běi lùn tán
刘振来|liú zhèn lái
王华庆|wáng huá qìng
肛栓母狗|gāng shuān mǔ gǒu
x民党|xmín dǎng
女激情|nǚ jī qíng
政府|zhèng fǔ
法轮大法|fǎ lún dà fǎ
三级电影|sān jí diàn yǐng
勤捞致|qín lāo zhì
戈博军刀|gē bó jūn dāo
刘亚洲|liú yà zhōu
塔利班|tǎ lì bān
雅虎香港|yǎ hǔ xiāng gǎng
被指抄袭|bèi zhǐ chāo xí
论功|lùn gōng
法.轮.功|fǎ .lún .gōng
激情短|jī qíng duǎn
宇宙主佛|yǔ zhòu zhǔ fó
中华人民正邪|zhōng huá rén mín zhèng xié
鸡奸|jī jiān
淫液|yín yè
法拉盛缅街|fǎ lā shèng miǎn jiē
肉棒|ròu bàng
张丹红|zhāng dān hóng
狗日的|gǒu rì de
張丕林|zhāng pī lín
手机追|shǒu jī zhuī
回复可见|huí fù kě jiàn
娶韩国|qǔ hán guó
蚁力神|yǐ lì shén
淫浪|yín làng
中石化说亏损|zhōng shí huà shuō kuī sǔn
豪乳|háo rǔ
阴户|yīn hù
少修正|shǎo xiū zhèng
官也不容|guān yě bù róng
徐明|xú míng
灵动卡|líng dòng qiǎ
暴乳|bào rǔ
邓玉娇|dèng yù jiāo
陈相贵|chén xiāng guì
亚硝酸乙酯|yà xiāo suān yǐ zhǐ
发抡|fā lún
阿兰德龙户外|ā lán dé lóng hù wài
有军用枪支出售|yǒu jūn yòng qiāng zhī chū shòu
供应汽枪|gōng yìng qì qiāng
北京之春|běi jīng zhī chūn
昏药|hūn yào
陈冀平|chén jì píng
瓮安|wèng ān
马良骏|mǎ liáng jùn
到花心|dào huā xīn
透视镜|tòu shì jìng
参加者回忆录|cān jiā zhě huí yì lù
肖钢|xiào gāng
性爱|xìng ài
浪妇|làng fù
供应弓弩麻醉箭|gōng yìng gōng nǔ má zuì jiàn
团派政治明星|tuán pài zhèng zhì míng xīng
兽性|shòu xìng
警察被|jǐng chá bèi
廉政大论坛|lián zhèng dà lùn tán
政府操|zhèng fǔ cāo
潮喷|cháo pēn
圣火护卫|shèng huǒ hù wèi
网民案|wǎng mín àn
炸药及其制造方法|zhà yào jí qí zhì zào fāng fǎ
甲虫跳|jiǎ chóng tiào
国际特赦|guó jì tè shè
江棋生|jiāng qí shēng
林保华|lín bǎo huá
炸药制造生产工艺|zhà yào zhì zào shēng chǎn gōng yì
绿色雨|lǜ sè yǔ
伦公|lún gōng
因毒磷|yīn dú lín
男奴|nán nú
易丹轩|yì dān xuān
阿凡提机|ā fán tí jī
代写代发各种职称|dài xiě dài fā gè zhǒng zhí chēng
宙最高法|zhòu zuì gāo fǎ
推油|tuī yóu
冷钢刀具直销网|lěng gāng dāo jù zhí xiāo wǎng
信用卡空卡|xìn yòng qiǎ kōng qiǎ
夫妻交换|fū qī jiāo huàn
诉讼集团|sù sòng jí tuán
当官在于|dāng guān zài yú
猫贼洞|māo zéi dòng
广安|guǎng ān
办假|bàn jiǎ
高校骚乱|gāo xiào sāo luàn
网络评论员|wǎng luò píng lùn yuán
中办发|zhōng bàn fā
荡尽天下|dàng jǐn tiān xià
灭绝罪|miè jué zuì
燃烧瓶|rán shāo píng
军刀专卖军刺|jūn dāo zhuān mài jūn cì
公开批评中央高层领导人|gōng kāi pī píng zhōng yāng gāo céng lǐng dǎo rén
调教|diào jiào
示威|shì wēi
少妇|shǎo fù
明hui|míng hui
肉洞|ròu dòng
党风日下|dǎng fēng rì xià
按摩棒|àn mó bàng
DIY原子弹|DIYyuán zǐ dàn
军品军刺网|jūn pǐn jūn cì wǎng
基本配方是硝酸甘|jī běn pèi fāng shì xiāo suān gān
把病人整|bǎ bìng rén zhěng
高压气枪,气枪子弹|gāo yā qì qiāng ,qì qiāng zǐ dàn
卫星高频头|wèi xīng gāo pín tóu
百乐二呓|bǎi lè èr yì
谤罪获刑|bàng zuì huò xíng
简易炸药|jiǎn yì zhà yào
18届常委|18jiè cháng wěi
周恩来自责|zhōu ēn lái zì zé
李立国|lǐ lì guó
王毅|wáng yì
成人论坛|chéng rén lùn tán
相奸|xiāng jiān
做原子弹|zuò yuán zǐ dàn
陈水扁|chén shuǐ biǎn
一通健康法|yī tōng jiàn kāng fǎ
套牌车|tào pái chē
煞逼|shā bī
哈批|hā pī
铁血师|tiě xiě shī
发票代|fā piào dài
淪功|lún gōng
陈炳基|chén bǐng jī
林樵清|lín qiáo qīng
液体炸药配方|yè tǐ zhà yào pèi fāng
熊焱|xióng yàn
操你大爷|cāo nǐ dà yé
形透视镜|xíng tòu shì jìng
集体上访|jí tǐ shàng fǎng
脱衣|tuō yī
女士服务|nǚ shì fú wù
琼花问|qióng huā wèn
秃鹰汽|tū yīng qì
猎槍|liè qiāng
园惨案|yuán cǎn àn
64式手枪出售|64shì shǒu qiāng chū shòu
王维民|wáng wéi mín
司法黑|sī fǎ hēi
马红林|mǎ hóng lín
一党私利|yī dǎng sī lì
淫靡|yín mǐ
国产汽狗专卖|气枪货|guó chǎn qì gǒu zhuān mài |qì qiāng huò
奇迹的黄|qí jī de huáng
世纪中国基金会|shì jì zhōng guó jī jīn huì
代办学|dài bàn xué
出售:高仿真枪|chū shòu :gāo fǎng zhēn qiāng
中国政治新星|zhōng guó zhèng zhì xīn xīng
双十节|shuāng shí jié
吃人|chī rén
刘云山|liú yún shān
胡j涛|hú jtāo
六四资料馆|liù sì zī liào guǎn
生当作人杰之昨日重现|shēng dāng zuò rén jié zhī zuó rì zhòng xiàn
气枪专卖网|qì qiāng zhuān mài wǎng
家一样饱|jiā yī yáng bǎo
色情片|sè qíng piàn
胡王八|hú wáng bā
摸nai门|mō naimén
la萨|lasà
刘成军|liú chéng jūn
警民冲突|jǐng mín chōng tū
花和尚社区成人性用品|huā hé shàng shè qū chéng rén xìng yòng pǐn
十大禁|shí dà jìn
考中答案|kǎo zhōng dá àn
燕玲论坛|yàn líng lùn tán
军用弓弩公司|jūn yòng gōng nǔ gōng sī
刀架保安|dāo jià bǎo ān
香港马会|xiāng gǎng mǎ huì
轮奸|lún jiān
夜勤病栋|yè qín bìng dòng
郭罗基|guō luō jī
西藏天葬|xī cáng tiān zàng
李兰菊|lǐ lán jú
凹晕|āo yūn
颠覆中华人民共和国政|diān fù zhōng huá rén mín gòng hé guó zhèng
出售M1911|chū shòu M1911
美少妇|měi shǎo fù
花花公子|huā huā gōng zǐ
监听王|jiān tīng wáng
benzodiazepines|benzodiazepines
KC短信|KCduǎn xìn
喝血社会|hē xiě shè huì
济世灵文|jì shì líng wén
张林|zhāng lín
证书办|zhèng shū bàn
懊孕|ào yùn
共产党专制|gòng chǎn dǎng zhuān zhì
zha药|zhayào
代辦信用卡|dài bàn xìn yòng qiǎ
长期出 售手枪|cháng qī chū  shòu shǒu qiāng
罚仑|fá lún
自动群发|zì dòng qún fā
蔡武|cài wǔ
孙大发|sūn dà fā
工力人|gōng lì rén
台*湾|tái *wān
世界日报|shì jiè rì bào
第21集团军|dì 21jí tuán jūn
警用品|jǐng yòng pǐn
迟浩田|chí hào tián
徐匡迪|xú kuāng dí
天下互联|tiān xià hù lián
十七大|shí qī dà
华国锋|huá guó fēng
网评员|wǎng píng yuán
房贷给废|fáng dài gěi fèi
工程吞得|gōng chéng tūn dé
爱他死|ài tā sǐ
遭警察|zāo jǐng chá
金道铭|jīn dào míng
马飚|mǎ biāo
何家栋|hé jiā dòng
张庆黎|zhāng qìng lí
恶势力操|è shì lì cāo
递纸死|dì zhǐ sǐ
梁保华|liáng bǎo huá
章沁生|zhāng qìn shēng
无耻语录|wú chǐ yǔ lù
赵紫阳|zhào zǐ yáng
军用手枪钢珠枪|jūn yòng shǒu qiāng gāng zhū qiāng
安南|ān nán
三棱军刺专卖|sān léng jūn cì zhuān mài
m功学|mgōng xué
户外军刀网|hù wài jūn dāo wǎng
习进平|xí jìn píng
洪智|hóng zhì
萨拉托加|sà lā tuō jiā
六位qq|liù wèi qq
筏轮|fá lún
中国的陷阱|zhōng guó de xiàn jǐng
兴奋剂|xīng fèn jì
兴华论谈|xīng huá lùn tán
圣战不息|shèng zhàn bù xī
爱液|ài yè
日月气功|rì yuè qì gōng
陈蒙|chén méng
线透视镜|xiàn tòu shì jìng
肛门是邻|gāng mén shì lín
耶稣基督血水圣灵全备福音布道团|yé sū jī dū xiě shuǐ shèng líng quán bèi fú yīn bù dào tuán
淫教师|yín jiào shī
罂粟壳|yīng sù ké
李希|lǐ xī
沈德咏|shěn dé yǒng
罢饭|bà fàn
安街逆|ān jiē nì
江书记|jiāng shū jì
中宣部|zhōng xuān bù
TNT 炸弹的制作|TNT zhà dàn de zhì zuò
苗圩|miáo wéi
群发软件|qún fā ruǎn jiàn
刘玉亭|liú yù tíng
粘氯酸|zhān lǜ suān
手机窃|shǒu jī qiè
幕前戲|mù qián xì
出售手枪 电话|chū shòu shǒu qiāng  diàn huà
元一夜|yuán yī yè
6四|6sì
都当警|dū dāng jǐng
中电信|zhōng diàn xìn
习太子|xí tài zǐ
A片|Apiàn
藏人|cáng rén
现在的共产党|xiàn zài de gòng chǎn dǎng
中共解体|zhōng gòng jiě tǐ
江绵恒|jiāng mián héng
保过答案|bǎo guò dá àn
三挫|sān cuò
裸聊网|luǒ liáo wǎng
失身粉|shī shēn fěn
江泽慧|jiāng zé huì
温加保|wēn jiā bǎo
失意药|shī yì yào
克分析|kè fēn xī
吹喇叭|chuī lǎ bā
炸药的制作|zhà yào de zhì zuò
開票|kāi piào
布局十八大|bù jú shí bā dà
炸dan|zhà dan
陆委会|lù wěi huì
私人侦探|sī rén zhēn tàn
解体的命运|jiě tǐ de mìng yùn
干穴|gān xué
g匪|gfěi
李咏曰|lǐ yǒng yuē
有码|yǒu mǎ
羅幹|luó gàn
万能钥匙|wàn néng yào chí
读不起选个学校三万起|dú bù qǐ xuǎn gè xué xiào sān wàn qǐ
于起龙|yú qǐ lóng
64运动|64yùn dòng
砝囵|fá lún
法囵|fǎ lún
麦当劳被砸|mài dāng láo bèi zá
答案提供|dá àn tí gōng
四六级答案|sì liù jí dá àn
手机铃声下载|shǒu jī líng shēng xià zài
高清在线|gāo qīng zài xiàn
一ye情|yī yeqíng
上海垮台|shàng hǎi kuǎ tái
姚月谦|yáo yuè qiān
論公|lùn gōng
侯德健|hóu dé jiàn
折叠狗QQ|zhé dié gǒu QQ
淫女|yín nǚ
北京市亿霖|běi jīng shì yì lín
王辅臣|wáng fǔ chén
第一夫人|dì yī fū rén
出售手枪|chū shòu shǒu qiāng
发论工|fā lùn gōng
小口径|xiǎo kǒu jìng
及川奈央|jí chuān nài yāng
自由西藏|zì yóu xī cáng
区的雷人|qū de léi rén
足球投注|zú qiú tóu zhù
中国网络审查|zhōng guó wǎng luò shěn chá
三秒倒|sān miǎo dǎo
港料|gǎng liào
波霸|bō bà
插他|chā tā
巨屌|jù diǎo
林慎立|lín shèn lì
阴核|yīn hé
粉穴|fěn xué
迷奸药|mí jiān yào
共匪|gòng fěi
炮友|pào yǒu
煽动群众|shān dòng qún zhòng
陷害案|xiàn hài àn
杨传堂|yáng chuán táng
消防灭火枪|xiāo fáng miè huǒ qiāng
极端武力军品网|jí duān wǔ lì jūn pǐn wǎng
地塞米松|dì sāi mǐ sōng
毛zd|máo zd
卖车|mài chē
套弄|tào nòng
焚烧中国国旗|fén shāo zhōng guó guó qí
东社|dōng shè
售子弹|shòu zǐ dàn
阴毛|yīn máo
体位|tǐ wèi
十八届|shí bā jiè
藏春阁|cáng chūn gé
瓮安事件|wèng ān shì jiàn
出售进口金属枪模|chū shòu jìn kǒu jīn shǔ qiāng mó
贺卫方|hè wèi fāng
证一次性|zhèng yī cì xìng
被干|bèi gān
个人崇拜|gè rén chóng bài
权柄|quán bǐng
三唑|sān zuò
春夏论坛|chūn xià lùn tán
北韩|běi hán
共c党|gòng cdǎng
杨晶|yáng jīng
虎骑|hǔ qí
脏独|zāng dú
李景田|lǐ jǐng tián
王涵万|wáng hán wàn
卖自考|mài zì kǎo
珐纶|fà lún
迷情水出售|mí qíng shuǐ chū shòu
爱国者同盟网站|ài guó zhě tóng méng wǎng zhàn
温元凯|wēn yuán kǎi
现在的公安|xiàn zài de gōng ān
共残裆|gòng cán dāng
野营刀专卖|yě yíng dāo zhuān mài
沙皇李长春|shā huáng lǐ cháng chūn
中国时报|zhōng guó shí bào
阴囊|yīn náng
维权人|wéi quán rén
色b|sè b
哒赖|dā lài
军刀网军刀专卖|jūn dāo wǎng jūn dāo zhuān mài
上海孤儿院|shàng hǎi gū ér yuàn
均价|jūn jià
打飞机|dǎ fēi jī
食捻屎|shí niǎn shǐ
十七大人事安排|shí qī dà rén shì ān pái
于幼军|yú yòu jūn
茳澤民|jiāng zé mín
五不争鸣论坛|wǔ bù zhēng míng lùn tán
张惠新|zhāng huì xīn
华藏功|huá cáng gōng
自摸|zì mō
司徒华|sī tú huá
伪政府|wěi zhèng fǔ
大蓋帽|dà gài mào
南方军刀网|nán fāng jūn dāo wǎng
手榴弹|shǒu liú dàn
阴唇|yīn chún
马三家|mǎ sān jiā
十八庆红|shí bā qìng hóng
自制燃烧弹|zì zhì rán shāo dàn
燃烧辅助工具|rán shāo fǔ zhù gōng jù
迷魂药出售|mí hún yào chū shòu
包青天机|bāo qīng tiān jī
出售猎枪|chū shòu liè qiāng
刘刚|liú gāng
纪元|jì yuán
兼职打字录入|jiān zhí dǎ zì lù rù
人妻|rén qī
催情藥|cuī qíng yào
被操|bèi cāo
八九政治|bā jiǔ zhèng zhì
孟令伟|mèng lìng wěi
暴奸|bào jiān
则民|zé mín
乙烯甲醇|yǐ xī jiǎ chún
氢弹手|qīng dàn shǒu
简鸿章|jiǎn hóng zhāng
三步倒麻醉箭专卖|sān bù dǎo má zuì jiàn zhuān mài
美艳少妇|měi yàn shǎo fù
自焚|zì fén
个邪的党|gè xié de dǎng
三脱|sān tuō
温云松|wēn yún sōng
硝酸甘油炸弹制作|xiāo suān gān yóu zhà dàn zhì zuò
武警暴|wǔ jǐng bào
寂寞女|jì mò nǚ
诱惑|yòu huò
年事件|nián shì jiàn
如何制硝化甘油|rú hé zhì xiāo huà gān yóu
硝酸甘油炸弹制作方法|xiāo suān gān yóu zhà dàn zhì zuò fāng fǎ
嫖鸡|piào jī
沈浩波|shěn hào bō
89风波|89fēng bō
中华养生益智气|zhōng huá yǎng shēng yì zhì qì
第3代领导|dì 3dài lǐng dǎo
性伙伴|xìng huǒ bàn
王瑞林|wáng ruì lín
各种炸药配方大全|gè zhǒng zhà yào pèi fāng dà quán
反G|fǎn G
民主女神|mín zhǔ nǚ shén
英国金融时报|yīng guó jīn róng shí bào
浪女|làng nǚ
艳情小说|yàn qíng xiǎo shuō
江丑闻|jiāng chǒu wén
傅申奇|fù shēn qí
中南海黑幕|zhōng nán hǎi hēi mù
天按门|tiān àn mén
呻吟|shēn yín
许家屯|xǔ jiā tún
拉sa|lā sa
李愚蠢|lǐ yú chǔn
左棍|zuǒ gùn
滕文生|téng wén shēng
底制|dǐ zhì
中正纪念歌|zhōng zhèng jì niàn gē
代写计划书|dài xiě jì huá shū
快速办|kuài sù bàn
偷情|tōu qíng
水扁|shuǐ biǎn
仇共|chóu gòng
透视仪|tòu shì yí
每周一死|měi zhōu yī sǐ
疆独|jiāng dú
震惊一个民|zhèn jīng yī gè mín
聊斋艳|liáo zhāi yàn
妹疼|mèi téng
佛怀煽仇录|fó huái shān chóu lù
反腐败论坛|fǎn fǔ bài lùn tán
大2众卡|dà 2zhòng qiǎ
蒙古分裂分子|méng gǔ fēn liè fēn zǐ
筏沦|fá lún
迷情水|mí qíng shuǐ
校骚乱|xiào sāo luàn
水阎王|shuǐ yán wáng
西服进去|xī fú jìn qù
考机构|kǎo jī gōu
出售猎枪 QQ|chū shòu liè qiāng  QQ
雄烯二醇|xióng xī èr chún
打砸办公|dǎ zá bàn gōng
哪里有钢珠枪|nǎ lǐ yǒu gāng zhū qiāng
反政府|fǎn zhèng fǔ
江蛤蟆|jiāng há má
射网枪|shè wǎng qiāng
伊拉克|yī lā kè
陈润儿|chén rùn ér
清除负面|qīng chú fù miàn
李斌|lǐ bīn
抽一插|chōu yī chā
连胜德|lián shèng dé
售健卫|shòu jiàn wèi
曾宪梓|céng xiàn zǐ
中纪委|zhōng jì wěi
递进民主|dì jìn mín zhǔ
青天白日|qīng tiān bái rì
罗蒙马格赛基金会|luō méng mǎ gé sài jī jīn huì
淫荡自慰器|yín dàng zì wèi qì
高爆炸药的基本配方|gāo bào zhà yào de jī běn pèi fāng
裙中性运动|qún zhōng xìng yùn dòng
马志鹏|mǎ zhì péng
中华讲清|zhōng huá jiǎng qīng
纽崔莱七折|niǔ cuī lái qī zhé
装b|zhuāng b
一肖|yī xiào
猎枪子弹底火专卖|liè qiāng zǐ dàn dǐ huǒ zhuān mài
水浴法制TNT|shuǐ yù fǎ zhì TNT
园凶杀|yuán xiōng shā
口蹄疫|kǒu tí yì
晚年周恩来|wǎn nián zhōu ēn lái
刘春良|liú chūn liáng
18禁|18jìn
三三九乘元功|sān sān jiǔ chéng yuán gōng
乙酸三甲基锡|yǐ suān sān jiǎ jī xí
k粉|kfěn
遭到警|zāo dào jǐng
华闻|huá wén
拆迁灭|chāi qiān miè
供应弩捕狗箭|gōng yìng nǔ bǔ gǒu jiàn
舆论反制|yú lùn fǎn zhì
翁安|wēng ān
89之|89zhī
特共|tè gòng
出售肾|chū shòu shèn
贪污犯|tān wū fàn
叫床|jiào chuáng
四川独立|sì chuān dú lì
Dfdz|Dfdz
李盛霖|lǐ shèng lín
孙春兰|sūn chūn lán
人权律|rén quán lǜ
陈随便|chén suí biàn
专业办理|zhuān yè bàn lǐ
陈新权|chén xīn quán
群奸暴|qún jiān bào
李安东|lǐ ān dōng
王乐泉|wáng lè quán
北京帮|běi jīng bāng
北大三角|běi dà sān jiǎo
从陈良宇倒台看中国政局走势|cóng chén liáng yǔ dǎo tái kàn zhōng guó zhèng jú zǒu shì
渊盖苏文|yuān gài sū wén
轮子功|lún zǐ gōng
自杀手册|zì shā shǒu cè
台百度湾|tái bǎi dù wān
人民币恶搞|rén mín bì è gǎo
共惨|gòng cǎn
网民诬|wǎng mín wú
闻封锁|wén fēng suǒ
博会暂停|bó huì zàn tíng
胡惊涛|hú jīng tāo
张成寅|zhāng chéng yín
《动向》|《dòng xiàng 》
都当小姐|dū dāng xiǎo jiě
出售军刺|chū shòu jūn cì
陈良宇|chén liáng yǔ
李克|lǐ kè
集束炸弹制作|jí shù zhà dàn zhì zuò
淫亵|yín xiè
府集中领|fǔ jí zhōng lǐng
希脏|xī zāng
车仑大法|chē lún dà fǎ
现金投注|xiàn jīn tóu zhù
鸥之歌|ōu zhī gē
按照马雅历法|àn zhào mǎ yǎ lì fǎ
汽车走表器|qì chē zǒu biǎo qì
英雄纪念碑|yīng xióng jì niàn bēi
勃朗宁军刀|bó lǎng níng jūn dāo
特卖会|tè mài huì
绕过封锁|rào guò fēng suǒ
操我|cāo wǒ
五毛党|wǔ máo dǎng
五出三进|wǔ chū sān jìn
陈同海|chén tóng hǎi
韩联潮|hán lián cháo
珐伦|fà lún
共青团背景|gòng qīng tuán bèi jǐng
全家不得好死|quán jiā bù dé hǎo sǐ
胡boss|hú boss
liuhecai|liuhecai
电鸡|diàn jī
黄丽满|huáng lì mǎn
办本科|bàn běn kē
弓弩一百专卖店|gōng nǔ yī bǎi zhuān mài diàn
袁荣祥|yuán róng xiáng
刘士贤司马晋|liú shì xián sī mǎ jìn
江三条腿|jiāng sān tiáo tuǐ
广东五元集团|guǎng dōng wǔ yuán jí tuán
如厕死|rú cè sǐ
电视流氓|diàn shì liú máng
胡江|hú jiāng
4风|4fēng
女人和狗|nǚ rén hé gǒu
尉健行|wèi jiàn xíng
矿难不公|kuàng nán bù gōng
欠干|qiàn gān
妓女|jì nǚ
费私服|fèi sī fú
李小朋|lǐ xiǎo péng
反攻大陆|fǎn gōng dà lù
丹增嘉措|dān zēng jiā cuò
自由亚洲|zì yóu yà zhōu
限制|xiàn zhì
筏伦|fá lún
台湾联盟|tái wān lián méng
89事件|89shì jiàn
A级|Ají
陰唇|yīn chún
打错门|dǎ cuò mén
幕没有不|mù méi yǒu bù
访民|fǎng mín
监狱里的斗争|jiān yù lǐ de dǒu zhēng
港馬會|gǎng mǎ huì
登天梯|dēng tiān tī
杨刚|yáng gāng
中国泛蓝联盟|zhōng guó fàn lán lián méng
弓弩专卖店|gōng nǔ zhuān mài diàn
恶警|è jǐng
售手枪QQ|shòu shǒu qiāng QQ
淫兽学园|yín shòu xué yuán
乏纶|fá lún
轮操|lún cāo
原子弹制作|yuán zǐ dàn zhì zuò
性爱日|xìng ài rì
移动集团|yí dòng jí tuán
突破网封索的软件|tū pò wǎng fēng suǒ de ruǎn jiàn
中国共产党|zhōng guó gòng chǎn dǎng
麻果丸|má guǒ wán
李淑娴|lǐ shú xián
法lun|fǎ lun
司马义·铁力瓦尔地|sī mǎ yì ·tiě lì wǎ ěr dì
售氯胺|shòu lǜ àn
入耳关|rù ěr guān
代表烦|dài biǎo fán
南大论坛|nán dà lùn tán
擦你妈|cā nǐ mā
twdl|twdl
法伦|fǎ lún
人体艺|rén tǐ yì
乳爆|rǔ bào
白恩培|bái ēn péi
车仑|chē lún
共产主义的幽灵|gòng chǎn zhǔ yì de yōu líng
素人|sù rén
江戏子|jiāng xì zǐ
最新销售汽狗|zuì xīn xiāo shòu qì gǒu
操他妈|cāo tā mā
乙醇腈|yǐ chún jīng
瑞安事件|ruì ān shì jiàn
刘晓凯|liú xiǎo kǎi
买卖枪支|mǎi mài qiāng zhī
李克强第五代领导人|lǐ kè qiáng dì wǔ dài lǐng dǎo rén
猛插|měng chā
江则民|jiāng zé mín
爆发骚|bào fā sāo
手把手教你做炸弹|shǒu bǎ shǒu jiào nǐ zuò zhà dàn
王进东|wáng jìn dōng
蒙独|méng dú
法会|fǎ huì
密穴|mì xué
贾育台|jiǎ yù tái
外围|wài wéi
佳静安定|jiā jìng ān dìng
江八点.江独裁|jiāng bā diǎn .jiāng dú cái
光复民国|guāng fù mín guó
强歼|qiáng jiān
C4塑胶炸药|C4sù jiāo zhà yào
中国真实内容|zhōng guó zhēn shí nèi róng
彩票预测|cǎi piào yù cè
辦證|bàn zhèng
柳树中学|liǔ shù zhōng xué
仿真枪|fǎng zhēn qiāng
气枪价格，气枪专卖店|qì qiāng jià gé ，qì qiāng zhuān mài diàn
麻醉狗|má zuì gǒu
范长龙|fàn cháng lóng
倫功|lún gōng
台湾独|tái wān dú
肏你|cào nǐ
迷幻藥|mí huàn yào
人员变动|rén yuán biàn dòng
剩火|shèng huǒ
胸主席|xiōng zhǔ xí
香港生子|xiāng gǎng shēng zǐ
齐墨|qí mò
UP8新势力|UP8xīn shì lì
暴行|bào xíng
娄义|lóu yì
讲法传功|jiǎng fǎ chuán gōng
阻击枪/汽枪/高压气枪|zǔ jí qiāng /qì qiāng /gāo yā qì qiāng
旦科|dàn kē
甸果敢|diàn guǒ gǎn
人类罪恶论|rén lèi zuì è lùn
短信截|duǎn xìn jié
民族问题|mín zú wèn tí
江核心|jiāng hé xīn
专业代写|zhuān yè dài xiě
至国家高|zhì guó jiā gāo
新华内情|xīn huá nèi qíng
惹的国|rě de guó
安非他命|ān fēi tā mìng
诺贝尔和平奖|nuò bèi ěr hé píng jiǎng
外蒙|wài méng
啦萨|la sà
玉乳|yù rǔ
贷借款|dài jiè kuǎn
色视频|sè shì pín
腐败中国|fǔ bài zhōng guó
造反|zào fǎn
园血案|yuán xiě àn
倫公|lún gōng
冈本真|gāng běn zhēn
回民暴动|huí mín bào dòng
名山县|míng shān xiàn
他们嫌我挡了城市的道路|tā men xián wǒ dǎng le chéng shì de dào lù
枪子弹|qiāng zǐ dàn
康没有不|kāng méi yǒu bù
轮功|lún gōng
成人小说|chéng rén xiǎo shuō
毛贼|máo zéi
内幕|nèi mù
伦理片|lún lǐ piàn
杂志|zá zhì
标准炸弹教程|biāo zhǔn zhà dàn jiào chéng
书记|shū jì
哪里有真枪卖买|nǎ lǐ yǒu zhēn qiāng mài mǎi
露点|lù diǎn
江贼|jiāng zéi
白嫩|bái nèn
喷雾蒙汗药|pēn wù méng hàn yào
反腐总攻|fǎn fǔ zǒng gōng
当代七整|dāng dài qī zhěng
猎枪专卖店|liè qiāng zhuān mài diàn
李克强接班人|lǐ kè qiáng jiē bān rén
中共|zhōng gòng
胡海峰|hú hǎi fēng
威而柔|wēi ér róu
出售气狗|chū shòu qì gǒu
泽民|zé mín
陈建国|chén jiàn guó
刘鹏|liú péng
供应军用弩折叠弩|gōng yìng jūn yòng nǔ zhé dié nǔ
狙击枪|jū jí qiāng
洗澡死|xǐ zǎo sǐ
改革历程|gǎi gé lì chéng
法轮功|fǎ lún gōng
泼尼松|pō ní sōng
附送枪|fù sòng qiāng
史莲喜|shǐ lián xǐ
几吧|jī ba
窃听|qiè tīng
王寿祥|wáng shòu xiáng
李春城|lǐ chūn chéng
法O功|fǎ Ogōng
股市圈钱|gǔ shì quān qián
走光|zǒu guāng
奥晕|ào yūn
奚国华|xī guó huá
砝论|fá lùn
狗产蛋|gǒu chǎn dàn
苏晓康|sū xiǎo kāng
赵海青|zhào hǎi qīng
贱b|jiàn b
统一教|tǒng yī jiào
中共十八大热门人选|zhōng gòng shí bā dà rè mén rén xuǎn
军刀直刀军品网|jūn dāo zhí dāo jūn pǐn wǎng
温总理|wēn zǒng lǐ
军刀直销网|jūn dāo zhí xiāo wǎng
原子弹|yuán zǐ dàn
真理教|zhēn lǐ jiào
江浙闽|jiāng zhè mǐn
种学历证|zhǒng xué lì zhèng
突破封锁|tū pò fēng suǒ
陈际瓦|chén jì wǎ
强效失意药|qiáng xiào shī yì yào
霍英东临终遗言|huò yīng dōng lín zhōng yí yán
吾尔开西|wú ěr kāi xī
18大的人事安排意见|18dà de rén shì ān pái yì jiàn
子女任职名|zǐ nǚ rèn zhí míng
控诉世博|kòng sù shì bó
司考答案|sī kǎo dá àn
售步枪|shòu bù qiāng
大中国论坛|dà zhōng guó lùn tán
赴港生子|fù gǎng shēng zǐ
无码专|wú mǎ zhuān
联总这声传单|lián zǒng zhè shēng chuán dān
乏囵|fá lún
李世明|lǐ shì míng
Zha药制造进程|Zhayào zhì zào jìn chéng
邓小平|dèng xiǎo píng
新型毒品|xīn xíng dú pǐn
软弱的国|ruǎn ruò de guó
情聊天室|qíng liáo tiān shì
公司主要销售|gōng sī zhǔ yào xiāo shòu
援藏|yuán cáng
僵贼|jiāng zéi
硝铵炸药配方|xiāo ān zhà yào pèi fāng
狂干|kuáng gān
邵明立|shào míng lì
阿共|ā gòng
师涛|shī tāo
安眠酮|ān mián tóng
群发广告机|qún fā guǎng gào jī
信访|xìn fǎng
制证定金|zhì zhèng dìng jīn
咖啡因|kā fēi yīn
中共邪毒素|zhōng gòng xié dú sù
射爽|shè shuǎng
罢食|bà shí
灌肠自慰器|guàn cháng zì wèi qì
吴琼花问|wú qióng huā wèn
第5代领导|dì 5dài lǐng dǎo
田停工|tián tíng gōng
刘永治|liú yǒng zhì
淫兽学|yín shòu xué
天推广歌|tiān tuī guǎng gē
自sha|zì sha
突厥斯坦|tū jué sī tǎn
民联|mín lián
玉女心经|yù nǚ xīn jīng
基督教科学箴言报|jī dū jiào kē xué zhēn yán bào
食堂涨价|shí táng zhǎng jià
融通国际|róng tōng guó jì
异硫氰酸烯丙酯|yì liú qīng suān xī bǐng zhǐ
令狐计划|lìng hú jì huá
印尼屠华|yìn ní tú huá
李旺阳|lǐ wàng yáng
爽死我了|shuǎng sǐ wǒ le
黑火药和硝酸钾农药混合|hēi huǒ yào hé xiāo suān jiǎ nóng yào hùn hé
硝酸甘油|xiāo suān gān yóu
工自联|gōng zì lián
出售仿真枪|chū shòu fǎng zhēn qiāng
氯噻嗪|lǜ sai qín
亚砷酸钾|yà shēn suān jiǎ
颜射|yán shè
寂寞男|jì mò nán
朱云来|zhū yún lái
於幼軍|yú yòu jūn
邪恶|xié è
通钢总经|tōng gāng zǒng jīng
温jb|wēn jb
砝轮|fá lún
天要灭|tiān yào miè
不爱党|bù ài dǎng
儿园惨|ér yuán cǎn
推背图|tuī bèi tú
黄色电影|huáng sè diàn yǐng
铁道部|tiě dào bù
中共政治游戏|zhōng gòng zhèng zhì yóu xì
国家安全|guó jiā ān quán
diacetylmorphine|diacetylmorphine
办理资格|bàn lǐ zī gé
门保健|mén bǎo jiàn
对共产党清算|duì gòng chǎn dǎng qīng suàn
圣灵重建教会|shèng líng zhòng jiàn jiào huì
刘玉浦|liú yù pǔ
找个妈妈|zhǎo gè mā mā
哪里能买到自制手枪|nǎ lǐ néng mǎi dào zì zhì shǒu qiāng
法功|fǎ gōng
女优|nǚ yōu
焦国标|jiāo guó biāo
私处|sī chù
中共近期权力斗争|zhōng gòng jìn qī quán lì dǒu zhēng
手教你制作原子弹|shǒu jiào nǐ zhì zuò yuán zǐ dàn
第七代领导|dì qī dài lǐng dǎo
政治风波|zhèng zhì fēng bō
特上门|tè shàng mén
婴儿命|yīng ér mìng
卖发票|mài fā piào
手教你做原子弹|shǒu jiào nǐ zuò yuán zǐ dàn
林树森|lín shù sēn
杂志社征搞启事|zá zhì shè zhēng gǎo qǐ shì
买真枪|mǎi zhēn qiāng
TNT炸弹制作|TNTzhà dàn zhì zuò
十八大人事|shí bā dà rén shì
买卖54狗|mǎi mài 54gǒu
中共十八人事|zhōng gòng shí bā rén shì
曹清|cáo qīng
中国移动通信|zhōng guó yí dòng tōng xìn
中央zf|zhōng yāng zf
专业代|zhuān yè dài
炸学校|zhà xué xiào
告长期|gào cháng qī
脚交|jiǎo jiāo
达毕业证|dá bì yè zhèng
民猪|mín zhū
要泄了|yào xiè le
兰州军区|lán zhōu jūn qū
中南海秘闻|zhōng nán hǎi mì wén
性奴|xìng nú
炸弹|zhà dàn
珐沦|fà lún
高考黑|gāo kǎo hēi
迷失北京|mí shī běi jīng
温下台|wēn xià tái
a片|apiàn
俞杰|yú jié
林彪|lín biāo
化工厂爆炸|huà gōng chǎng bào zhà
抓胸|zhuā xiōng
李禄|lǐ lù
强硬发言|qiáng yìng fā yán
善恶有报|shàn è yǒu bào
李熙|lǐ xī
操逼|cāo bī
反腐败|fǎn fǔ bài
代孕|dài yùn
贺邦靖|hè bāng jìng
温影帝|wēn yǐng dì
江人马|jiāng rén mǎ
根达亚文明|gēn dá yà wén míng
鉴别铁观音|jiàn bié tiě guān yīn
来京上访|lái jīng shàng fǎng
亲日|qīn rì
共产王朝|gòng chǎn wáng zhāo
法轮|fǎ lún
张建平|zhāng jiàn píng
售肾|shòu shèn
震死他们|zhèn sǐ tā men
卖钢珠枪QQ|mài gāng zhū qiāng QQ
军刀专卖刀具批发|jūn dāo zhuān mài dāo jù pī fā
统独|tǒng dú
6合|6hé
阴门|yīn mén
李兆焯|lǐ zhào zhuó
省政府大门集合|shěng zhèng fǔ dà mén jí hé
生意宝|shēng yì bǎo
激情|jī qíng
泡友|pào yǒu
白景富|bái jǐng fù
轮大|lún dà
努尔白克力|nǔ ěr bái kè lì
丁子霖|dīng zǐ lín
景观住宅|jǐng guān zhù zhái
狗操|gǒu cāo
张培莉|zhāng péi lì
融资|róng zī
法伦功|fǎ lún gōng
板楼|bǎn lóu
仁青加|rén qīng jiā
李少民|lǐ shǎo mín
王力雄|wáng lì xióng
中南海惊现东宫小朝廷|zhōng nán hǎi jīng xiàn dōng gōng xiǎo zhāo tíng
法一轮一功|fǎ yī lún yī gōng
李录|lǐ lù
赌博机|dǔ bó jī
偷拍|tōu pāi
中共裁|zhōng gòng cái
獵槍|liè qiāng
黄献中|huáng xiàn zhōng
何清涟|hé qīng lián
妹上门|mèi shàng mén
学联|xué lián
伊斯兰运动|yī sī lán yùn dòng
熟女|shú nǚ
共产专制|gòng chǎn zhuān zhì
共字玄机|gòng zì xuán jī
王策|wáng cè
马恺|mǎ kǎi
如何推翻中共|rú hé tuī fān zhōng gòng
丝袜美|sī wà měi
淫电影|yín diàn yǐng
炸广州|zhà guǎng zhōu
色狼|sè láng
寂寞少妇|jì mò shǎo fù
妹痛|mèi tòng
针刺伤|zhēn cì shāng
东突解放组织|dōng tū jiě fàng zǔ zhī
群体灭绝|qún tǐ miè jué
石大华|shí dà huá
电话交友|diàn huà jiāo yǒu
皮箱炸弹|pí xiāng zhà dàn
吴学灿|wú xué càn
李瑞环|lǐ ruì huán
防电子眼|fáng diàn zǐ yǎn
支持台湾|zhī chí tái wān
径步枪|jìng bù qiāng
人弹|rén dàn
学习班|xué xí bān
邓榕|dèng róng
假发票|jiǎ fā piào
游xing|yóu xing
六四学生运动|liù sì xué shēng yùn dòng
虐待|nuè dài
地震来得更猛烈|dì zhèn lái dé gèng měng liè
藏m|cáng m
中国六四真相|zhōng guó liù sì zhēn xiāng
公安把秩序搞乱|gōng ān bǎ zhì xù gǎo luàn
下法轮|xià fǎ lún
葬独|zàng dú
嫖俄罗|piào é luō
沦公|lún gōng
脱光|tuō guāng
灯草和|dēng cǎo hé
重阳兵变|zhòng yáng bīng biàn
张宝顺|zhāng bǎo shùn
津地震|jīn dì zhèn
柳斌杰|liǔ bīn jié
总书记|zǒng shū jì
操了嫂|cāo le sǎo
柔胸粉|róu xiōng fěn
藏字石|cáng zì shí
江派人马|jiāng pài rén mǎ
轮手枪|lún shǒu qiāng
酥痒|sū yǎng
中共保命|zhōng gòng bǎo mìng
劣等民族|liè děng mín zú
政百度府|zhèng bǎi dù fǔ
毒豺|dú chái
园砍杀|yuán kǎn shā
防区和任务|fáng qū hé rèn wù
遥控信号拦截器|yáo kòng xìn hào lán jié qì
冰火|bīng huǒ
亡党亡国|wáng dǎng wáng guó
控制媒|kòng zhì méi
胡派人马|hú pài rén mǎ
民珠|mín zhū
中共十八大的基层选举|zhōng gòng shí bā dà de jī céng xuǎn jǔ
魏凤和|wèi fèng hé
蔡挺|cài tǐng
毕业證|bì yè zhèng
捕音王|bǔ yīn wáng
正府|zhèng fǔ
公检法是流氓|gōng jiǎn fǎ shì liú máng
白痴|bái chī
近親|jìn qīn
爆菊|bào jú
把学生整|bǎ xué shēng zhěng
苏绍智|sū shào zhì
BB枪|BBqiāng
气枪价格 仿真气枪|qì qiāng jià gé  fǎng zhēn qì qiāng
陈一咨|chén yī zī
一氯乙醛|yī lǜ yǐ quán
阿波罗网|ā bō luō wǎng
育部女官|yù bù nǚ guān
警察的幌|jǐng chá de huǎng
朱鎔基|zhū róng jī
民九亿商|mín jiǔ yì shāng
溫家寶|wēn jiā bǎo
亲共媒体|qīn gòng méi tǐ
护法|hù fǎ
疾病业债说|jí bìng yè zhài shuō
伦功|lún gōng
语家教|yǔ jiā jiào
拔出来|bá chū lái
長瀨愛|cháng lài ài
自由民主论坛|zì yóu mín zhǔ lùn tán
借腹生子|jiè fù shēng zǐ
陈车|chén chē
短信答案|duǎn xìn dá àn
八老|bā lǎo
罢吃|bà chī
汪东兴|wāng dōng xīng
短信:广告|duǎn xìn :guǎng gào
后庭|hòu tíng
爱液横流|ài yè héng liú
强奸处女|qiáng jiān chù nǚ
警察我们是为人民服务的|jǐng chá wǒ men shì wèi rén mín fú wù de
张仕波|zhāng shì bō
发票销|fā piào xiāo
西布曲明|xī bù qū míng
六和谐四|liù hé xié sì
满洲第三帝国|mǎn zhōu dì sān dì guó
中共的血旗|zhōng gòng de xiě qí
隆手指|lóng shǒu zhǐ
宋平|sòng píng
晕倒型|yūn dǎo xíng
苏家屯|sū jiā tún
手机魔卡|shǒu jī mó qiǎ
四事件|sì shì jiàn
习仲勋|xí zhòng xūn
张五常|zhāng wǔ cháng
张德江|zhāng dé jiāng
上中央|shàng zhōng yāng
燃烧剂的简易制作|rán shāo jì de jiǎn yì zhì zuò
骷髅死|kū lóu sǐ
丫与王益|yā yǔ wáng yì
简易燃烧弹|jiǎn yì rán shāo dàn
美国之音|měi guó zhī yīn
王俊莲|wáng jùn lián
重新评定|zhòng xīn píng dìng
星相|xīng xiāng
帮忙点下|bāng máng diǎn xià
黄殿中|huáng diàn zhōng
丽媛离|lì yuàn lí
董贵山|dǒng guì shān
暴力袭击|bào lì xí jí
南街村|nán jiē cūn
华语世界论坛|huá yǔ shì jiè lùn tán
刘凯中|liú kǎi zhōng
辦毕业|bàn bì yè
共一产一党|gòng yī chǎn yī dǎng
出售麻醉枪免收任何定金|chū shòu má zuì qiāng miǎn shōu rèn hé dìng jīn
江猪.江猪媳|jiāng zhū .jiāng zhū xí
风骚|fēng sāo
外汇局|wài huì jú
大参考|dà cān kǎo
第五代红人|dì wǔ dài hóng rén
拉帮游说|lā bāng yóu shuō
插我|chā wǒ
免费二级域名|miǎn fèi èr jí yù míng
仁吉旺姆|rén jí wàng mǔ
9坪|9píng
珐仑|fà lún
丝袜妹|sī wà mèi
川b26931|chuān b26931
校园改造工程|xiào yuán gǎi zào gōng chéng
蒙古独立|méng gǔ dú lì
七个军区|qī gè jūn qū
退dang|tuì dang
性饥渴|xìng jī kě
挨了一炮|āi le yī pào
中国弓驽网|zhōng guó gōng nú wǎng
武藤兰|wǔ téng lán
原子弹制作手册|yuán zǐ dàn zhì zuò shǒu cè
孙家正|sūn jiā zhèng
周天法|zhōu tiān fǎ
世界基督教统一神灵协会|shì jiè jī dū jiào tǒng yī shén líng xié huì
中国联通|zhōng guó lián tōng
子宫|zǐ gōng
罚伦|fá lún
蒋彦永|jiǎng yàn yǒng
司马璐回忆录|sī mǎ lù huí yì lù
蒋峰|jiǎng fēng
中共腐败|zhōng gòng fǔ bài
办理各种|bàn lǐ gè zhǒng
汪洋|wāng yáng
波推龙|bō tuī lóng
普提功|pǔ tí gōng
代开发票|dài kāi fā piào
乳沟|rǔ gōu
功法|gōng fǎ
东北独立|dōng běi dú lì
十大谎|shí dà huǎng
江泉集团|jiāng quán jí tuán
陪聊|péi liáo
刘奇葆|liú qí bǎo
粉碎四人帮|fěn suì sì rén bāng
火乍|huǒ zhà
发伦工|fā lún gōng
指点江山论坛|zhǐ diǎn jiāng shān lùn tán
别梦成灰|bié mèng chéng huī
孙政才|sūn zhèng cái
办理证书|bàn lǐ zhèng shū
胡权利瓜分|hú quán lì guā fēn
症腐|zhèng fǔ
昝爱宗|zǎn ài zōng
轻型巡航导弹的制作|qīng xíng xún háng dǎo dàn de zhì zuò
淫书|yín shū
共产|gòng chǎn
狩猎弓弩专卖网|shòu liè gōng nǔ zhuān mài wǎng
淫虫|yín chóng
供应发票|gōng yìng fā piào
举国体|jǔ guó tǐ
精神药品|jīng shén yào pǐn
试卷|shì juàn
中珙|zhōng gǒng
出售气枪|chū shòu qì qiāng
和狗性|hé gǒu xìng
用火药混合塑料|yòng huǒ yào hùn hé sù liào
钦本立|qīn běn lì
江梳头|jiāng shū tóu
魏家福|wèi jiā fú
罚囵|fá lún
考考邓|kǎo kǎo dèng
弓单|gōng dān
amateur|amateur
原子弹制作方法|yuán zǐ dàn zhì zuò fāng fǎ
严晓玲|yán xiǎo líng
马英九|mǎ yīng jiǔ
导爆索|dǎo bào suǒ
法论|fǎ lùn
体奸|tǐ jiān
安眠药|ān mián yào
信息产业部|xìn xī chǎn yè bù
铁凝|tiě níng
发论公|fā lùn gōng
多维|duō wéi
三步倒麻醉箭|sān bù dǎo má zuì jiàn
就去日|jiù qù rì
林炎志|lín yán zhì
輪功|lún gōng
网民获刑|wǎng mín huò xíng
胡春华|hú chūn huá
售冒名|shòu mào míng
中共三大势力谁来执政|zhōng gòng sān dà shì lì shuí lái zhí zhèng
成人电|chéng rén diàn
炸药的配方|zhà yào de pèi fāng
网赚队伍|wǎng zhuàn duì wǔ
刹笔|shā bǐ
女性自慰sex吧|nǚ xìng zì wèi sexba
开山刀砍刀出售|kāi shān dāo kǎn dāo chū shòu
政坛两黑马|zhèng tán liǎng hēi mǎ
醉钢枪|zuì gāng qiāng
顺利过|shùn lì guò
少年阿宾|shǎo nián ā bīn
你麻痹|nǐ má bì
仓井空|cāng jǐng kōng
先天健康法|xiān tiān jiàn kāng fǎ
信用危机|xìn yòng wēi jī
李建国|lǐ jiàn guó
灭共|miè gòng
文字狱|wén zì yù
上访|shàng fǎng
群射|qún shè
安全监管|ān quán jiān guǎn
摇头丸|yáo tóu wán
钦点接班人|qīn diǎn jiē bān rén
SM用品|SMyòng pǐn
赤化|chì huà
衡阳万通房产|héng yáng wàn tōng fáng chǎn
华门开|huá mén kāi
投注|tóu zhù
永伏虫|yǒng fú chóng
李远哲|lǐ yuǎn zhé
慕歌|mù gē
胡进涛|hú jìn tāo
炸药制|zhà yào zhì
捅你|tǒng nǐ
大陆官方|dà lù guān fāng
监听头|jiān tīng tóu
枪的结|qiāng de jié
西藏独|xī cáng dú
反雷达测速|fǎn léi dá cè sù
树亲民形象不如推动政改|shù qīn mín xíng xiàng bù rú tuī dòng zhèng gǎi
稀藏|xī cáng
金钟气|jīn zhōng qì
完全自杀手册|wán quán zì shā shǒu cè
方迷香|fāng mí xiāng
周年庆|zhōu nián qìng
吴宏达|wú hóng dá
红灯区|hóng dēng qū
考联盟|kǎo lián méng
天府广场|tiān fǔ guǎng cháng
许云昭|xǔ yún zhāo
东突厥斯坦解放组织|dōng tū jué sī tǎn jiě fàng zǔ zhī
午夜电|wǔ yè diàn
冯素英|féng sù yīng
江太上|jiāng tài shàng
末世论|mò shì lùn
退h集会|tuì hjí huì
徐乐江|xú lè jiāng
对中共的姑息就是对死难者的残忍|duì zhōng gòng de gū xī jiù shì duì sǐ nán zhě de cán rěn
江某某|jiāng mǒu mǒu
弓弩批发|gōng nǔ pī fā
禁书|jìn shū
毛太祖|máo tài zǔ
张志新|zhāng zhì xīn
色情小电影|sè qíng xiǎo diàn yǐng
三個代表|sān gè dài biǎo
席指着护|xí zhǐ zháo hù
轮攻|lún gōng
民意|mín yì
乳房|rǔ fáng
發淪|fā lún
麻果配|má guǒ pèi
骚乱|sāo luàn
发论|fā lùn
傅雯娟|fù wén juān
西班牙苍蝇水|xī bān yá cāng yíng shuǐ
钱运录|qián yùn lù
制作硝化甘油|zhì zuò xiāo huà gān yóu
荡女|dàng nǚ
中共黑|zhōng gòng hēi
风月大陆|fēng yuè dà lù
张国清|zhāng guó qīng
yang佳|yangjiā
详情请进入|xiáng qíng qǐng jìn rù
相自首|xiāng zì shǒu
吴胜利|wú shèng lì
你吗b|nǐ ma b
铁观音产地|tiě guān yīn chǎn dì
退党|tuì dǎng
8341部队|8341bù duì
仿品军刺网|fǎng pǐn jūn cì wǎng
联盟党|lián méng dǎng
谢长廷|xiè cháng tíng
罢考|bà kǎo
三利达弓弩直营|sān lì dá gōng nǔ zhí yíng
狂插性器具|kuáng chā xìng qì jù
出售器官|chū shòu qì guān
共产主义黑皮书|gòng chǎn zhǔ yì hēi pí shū
十八大人事安排意见|shí bā dà rén shì ān pái yì jiàn
水去车仑|shuǐ qù chē lún
十类人不|shí lèi rén bù
孙宝树|sūn bǎo shù
截访|jié fǎng
无抵押贷款|wú dǐ yā dài kuǎn
幼男|yòu nán
一氧化二氟|yī yǎng huà èr fú
沈阳军区|shěn yáng jūn qū
黄建国|huáng jiàn guó
色小说|sè xiǎo shuō
八级地震毫无预报|bā jí dì zhèn háo wú yù bào
合彩|hé cǎi
华夏文摘快递|huá xià wén zhāi kuài dì
肖捷|xiào jié
肖爱玲|xiào ài líng
成人激情|chéng rén jī qíng
一中一台|yī zhōng yī tái
黃麗滿|huáng lì mǎn
人民之声|rén mín zhī shēng
民主还专政|mín zhǔ huán zhuān zhèng
隐形耳机|yǐn xíng ěr jī
安立敏|ān lì mǐn
操你妈|cāo nǐ mā
屌|diǎo
露乳|lù rǔ
鸳鸯洗|yuān yāng xǐ
胡锦|hú jǐn
原子弹 制作方法|yuán zǐ dàn  zhì zuò fāng fǎ
府包庇|fǔ bāo bì
阿兰德龙野营刀|ā lán dé lóng yě yíng dāo
血溅人民天堂|xiě jiàn rén mín tiān táng
中国新民党|zhōng guó xīn mín dǎng
华岳|huá yuè
国家吞得|guó jiā tūn dé
乏沦|fá lún
丝情侣|sī qíng lǚ
理各种证|lǐ gè zhǒng zhèng
东方时空|dōng fāng shí kōng
民主墙|mín zhǔ qiáng
启蒙派|qǐ méng pài
藏青会|cáng qīng huì
歌功颂德|gē gōng sòng dé
藏民|cáng mín
成人文|chéng rén wén
买官卖官|mǎi guān mài guān
北京风波|běi jīng fēng bō
李鸿忠|lǐ hóng zhōng
口淫|kǒu yín
伊力哈木|yī lì hā mù
供应三利达弓弩麻醉箭|gōng yìng sān lì dá gōng nǔ má zuì jiàn
强jian|qiáng jian
阿兰得龙野营刀具网|ā lán dé lóng yě yíng dāo jù wǎng
你办事我放心|nǐ bàn shì wǒ fàng xīn
中共权斗|zhōng gòng quán dǒu
萨达姆|sà dá mǔ
代办信用卡|dài bàn xìn yòng qiǎ
刘晓江|liú xiǎo jiāng
台独|tái dú
胡锦滔|hú jǐn tāo
兽奸|shòu jiān
舔阴自慰器|tiǎn yīn zì wèi qì
落霞缀|luò xiá zhuì
共独|gòng dú
论攻|lùn gōng
第2代领导|dì 2dài lǐng dǎo
氧氯化磷|yǎng lǜ huà lín
洪传|hóng chuán
中共的腐败与残暴|zhōng gòng de fǔ bài yǔ cán bào
口爆|kǒu bào
插插|chā chā
法L|fǎ L
激流中国|jī liú zhōng guó
李荣融|lǐ róng róng
新疆獨立|xīn jiāng dú lì
美腿|měi tuǐ
气枪/猎枪/钢珠枪|qì qiāng /liè qiāng /gāng zhū qiāng
插b|chā b
野营刀具军品网|yě yíng dāo jù jūn pǐn wǎng
高文谦|gāo wén qiān
美国佬|měi guó lǎo
巨奶|jù nǎi
王金山|wáng jīn shān
供铲谠|gōng chǎn dǎng
独立台湾会|dú lì tái wān huì
国民党|guó mín dǎng
酸羟亚胺|suān qiǎng yà àn
迟万春|chí wàn chūn
舆论|yú lùn
春药|chūn yào
北京市委黑幕|běi jīng shì wěi hēi mù
胡江关系|hú jiāng guān xì
出售开山刀军刺|chū shòu kāi shān dāo jūn cì
中国复兴党|zhōng guó fù xīng dǎng
消声器|xiāo shēng qì
血色京畿|xiě sè jīng jī
氯胺酮|lǜ àn tóng
理是影帝|lǐ shì yǐng dì
DIY核弹|DIYhé dàn
插她|chā tā
顶贴机|dǐng tiē jī
爱国运动正名|ài guó yùn dòng zhèng míng
王冶坪|wáng yě píng
學生妹|xué shēng mèi
持不同政见|chí bù tóng zhèng jiàn
汽狗高压汽枪|qì gǒu gāo yā qì qiāng
发纶|fā lún
绵恒|mián héng
梦网洪志|mèng wǎng hóng zhì
黎安友|lí ān yǒu
黑火药的成分|hēi huǒ yào de chéng fēn
告全体网民书|gào quán tǐ wǎng mín shū
张健|zhāng jiàn
枪的制|qiāng de zhì
出售国产军用54手枪|chū shòu guó chǎn jūn yòng 54shǒu qiāng
九—评|jiǔ —píng
猎枪销售手枪销售气枪|liè qiāng xiāo shòu shǒu qiāng xiāo shòu qì qiāng
武警殴|wǔ jǐng ōu
《争鸣》|《zhēng míng 》
包二奶|bāo èr nǎi
你怎么用土办法做武器|nǐ zěn me yòng tǔ bàn fǎ zuò wǔ qì
嫩穴|nèn xué
法愣|fǎ lèng
护卫团|hù wèi tuán
答案包|dá àn bāo
李玉赋|lǐ yù fù
代考|dài kǎo
回良玉|huí liáng yù
军品特|jūn pǐn tè
印尼事件|yìn ní shì jiàn
姚增科|yáo zēng kē
殖器护|zhí qì hù
中国过渡政府|zhōng guó guò dù zhèng fǔ
考试包过|kǎo shì bāo guò
六月联盟|liù yuè lián méng
口射|kǒu shè
苍蝇水|cāng yíng shuǐ
聂树斌|niè shù bīn
天龙八部私服|tiān lóng bā bù sī fú
资金短缺|zī jīn duǎn quē
张晓平|zhāng xiǎo píng
透视扑|tòu shì pū
大法修炼者|dà fǎ xiū liàn zhě
做炸弹|zuò zhà dàn
血色京机|xiě sè jīng jī
新闻封锁|xīn wén fēng suǒ
嗑药|kè yào
夜總會|yè zǒng huì
吕祖善|lǚ zǔ shàn
换妻|huàn qī
8的平方事件|8de píng fāng shì jiàn
雷管出售|léi guǎn chū shòu
马大维|mǎ dà wéi
阿旺晋美|ā wàng jìn měi
要人权|yào rén quán
假文凭|jiǎ wén píng
民主不能等待|mín zhǔ bù néng děng dài
杨建亭|yáng jiàn tíng
迷奸香水出售|mí jiān xiāng shuǐ chū shòu
博彩娱|bó cǎi yú
泥马之歌|ní mǎ zhī gē
变牌绝|biàn pái jué
新金瓶|xīn jīn píng
地下先烈|dì xià xiān liè
戴秉国|dài bǐng guó
考前发放|kǎo qián fā fàng
犬交|quǎn jiāo
美国参考|měi guó cān kǎo
发轮|fā lún
葛振峰|gé zhèn fēng
人民报|rén mín bào
应召|yìng zhào
推翻社会主义制度|tuī fān shè huì zhǔ yì zhì dù
警用刀具出售|jǐng yòng dāo jù chū shòu
软弱外交|ruǎn ruò wài jiāo
李洪志|lǐ hóng zhì
沦功|lún gōng
文凭|wén píng
中国政府封锁消息|zhōng guó zhèng fǔ fēng suǒ xiāo xī
连准|lián zhǔn
弹夹|dàn jiā
党内危机|dǎng nèi wēi jī
气枪看货加QQ|qì qiāng kàn huò jiā QQ
專制|zhuān zhì
生孩子没屁眼|shēng hái zǐ méi pì yǎn
张荣坤|zhāng róng kūn
历史的伤口|lì shǐ de shāng kǒu
孔丹|kǒng dān
爆炸物|bào zhà wù
坦克压大学生|tǎn kè yā dà xué shēng
人游行|rén yóu xíng
人兽|rén shòu
党内权力|dǎng nèi quán lì
人事布局出手既稳又重|rén shì bù jú chū shǒu jì wěn yòu zhòng
台湾|tái wān
保密室|bǎo mì shì
伊東|yī dōng
江浙民|jiāng zhè mín
628事件|628shì jiàn
外透视镜|wài tòu shì jìng
Ｋ粉|Ｋfěn
民主|mín zhǔ
文凭证|wén píng zhèng
闻被控制|wén bèi kòng zhì
坐台|zuò tái
封锁消|fēng suǒ xiāo
高校群体事件|gāo xiào qún tǐ shì jiàn
弹药|dàn yào
郭平|guō píng
九抨|jiǔ pēng
北姑|běi gū
共残主义|gòng cán zhǔ yì
阉割|yān gē
大澤惠|dà zé huì
浪叫|làng jiào
江猪|jiāng zhū
手机监|shǒu jī jiān
六四事|liù sì shì
证件集团|zhèng jiàn jí tuán
进攻台湾|jìn gōng tái wān
改卷内幕|gǎi juàn nèi mù
仇保兴|chóu bǎo xīng
爽片|shuǎng piàn
爆破和杀伤燃烧弹|bào pò hé shā shāng rán shāo dàn
钢珠弓弩专卖店|gāng zhū gōng nǔ zhuān mài diàn
湖紧掏|hú jǐn tāo
黄作兴|huáng zuò xīng
进口气枪,气枪子弹|jìn kǒu qì qiāng ,qì qiāng zǐ dàn
沈跃跃|shěn yuè yuè
主席李世民|zhǔ xí lǐ shì mín
江蛤蟆.江核心|jiāng há má .jiāng hé xīn
民政部|mín zhèng bù
拉票贿选|lā piào huì xuǎn
供应军用手枪|gōng yìng jūn yòng shǒu qiāng
中国zf|zhōng guó zf
谓的和谐|wèi de hé xié
狂搞|kuáng gǎo
台弯|tái wān
中国战神军用弓弩|zhōng guó zhàn shén jūn yòng gōng nǔ
干以胜|gān yǐ shèng
里有汽枪出售|lǐ yǒu qì qiāng chū shòu
如6意通|rú 6yì tōng
奥孕|ào yùn
福娃頭上|fú wá tóu shàng
替考|tì kǎo
高干子弟|gāo gān zǐ dì
李小鹏|lǐ xiǎo péng
发贴工具|fā tiē gōng jù
周生贤|zhōu shēng xián
3D轮盘|3Dlún pán
信号枪|xìn hào qiāng
宪政|xiàn zhèng
性服务|xìng fú wù
美国广播公司|měi guó guǎng bō gōng sī
汤涛|tāng tāo
贪官也辛|tān guān yě xīn
冷钢刀具专卖|lěng gāng dāo jù zhuān mài
专业代考|zhuān yè dài kǎo
兴中心幼|xīng zhōng xīn yòu
何峰|hé fēng
代理票据|dài lǐ piào jù
青天白日旗|qīng tiān bái rì qí
王侠|wáng xiá
大史记|dà shǐ jì
西点军品军刀网|xī diǎn jūn pǐn jūn dāo wǎng
四海帮|sì hǎi bāng
潘国平|pān guó píng
台湾有权独立|tái wān yǒu quán dú lì
身份证生成器|shēn fèn zhèng shēng chéng qì
上海独立|shàng hǎi dú lì
吴爱|wú ài
防卫棍刀户外刀具|fáng wèi gùn dāo hù wài dāo jù
性虎|xìng hǔ
手机监听器|shǒu jī jiān tīng qì
仿真手枪|fǎng zhēn shǒu qiāng
中共的罪恶|zhōng gòng de zuì è
考试保|kǎo shì bǎo
军用弓弩专卖店|jūn yòng gōng nǔ zhuān mài diàn
婴儿汤|yīng ér tāng
曾慶紅|céng qìng hóng
高层人事变动|gāo céng rén shì biàn dòng
流亡藏人|liú wáng cáng rén
陈破空|chén pò kōng
真善美|zhēn shàn měi
李鵬|lǐ péng
硝酸甘油炸药制作|xiāo suān gān yóu zhà yào zhì zuò
贾庆林|jiǎ qìng lín
传奇SF|chuán qí SF
杨洁篪|yáng jí chí
色情|sè qíng
速代办|sù dài bàn
酸甘油炸药|suān gān yóu zhà yào
中朝|zhōng zhāo
黄兴国|huáng xīng guó
军刀价格军用刀具|jūn dāo jià gé jūn yòng dāo jù
戴相龙|dài xiāng lóng
轮子小报|lún zǐ xiǎo bào
秃鹰气枪货到付款|tū yīng qì qiāng huò dào fù kuǎn
绩过后付|jī guò hòu fù
加盟连锁|jiā méng lián suǒ
军用54出售|jūn yòng 54chū shòu
阴精|yīn jīng
姚明进去|yáo míng jìn qù
徐绍史|xú shào shǐ
肉逼|ròu bī
迷魂藥|mí hún yào
正规期刊征集|zhèng guī qī kān zhēng jí
运动正名|yùn dòng zhèng míng
高智晟|gāo zhì shèng
董建华|dǒng jiàn huá
九评|jiǔ píng
偷听器|tōu tīng qì
轻松过|qīng sōng guò
王洛林|wáng luò lín
电子狗导航手机|diàn zǐ gǒu dǎo háng shǒu jī
江澤民|jiāng zé mín
告全国股民同胞书|gào quán guó gǔ mín tóng bāo shū
异议人士|yì yì rén shì
一折起|yī zhé qǐ
广安事件|guǎng ān shì jiàn
供应麻醉箭三步倒|gōng yìng má zuì jiàn sān bù dǎo
张轩|zhāng xuān
麻衣|má yī
北京独立|běi jīng dú lì
猎好帮手|liè hǎo bāng shǒu
尼可刹米|ní kě shā mǐ
中的班禅|zhōng de bān shàn
成人色情|chéng rén sè qíng
杜宇新|dù yǔ xīn
港澳博球|gǎng ào bó qiú
穆罕穆德|mù hǎn mù dé
台湾建国运动组织|tái wān jiàn guó yùn dòng zǔ zhī
同胞书|tóng bāo shū
刻章办|kè zhāng bàn
磕彰|kē zhāng
舔阴|tiǎn yīn
遭便衣|zāo biàn yī
军刺|jūn cì
外交论坛|wài jiāo lùn tán
大学暴动|dà xué bào dòng
第6代领导|dì 6dài lǐng dǎo
出售雷管炸药|chū shòu léi guǎn zhà yào
销售小口径步枪|xiāo shòu xiǎo kǒu jìng bù qiāng
园发生砍|yuán fā shēng kǎn
小口径秃鹰沙漠|xiǎo kǒu jìng tū yīng shā mò
押题|yā tí
草你吗|cǎo nǐ ma
抢劫药|qiǎng jié yào
淫騷妹|yín sāo mèi
紅智|hóng zhì
周恩来后悔|zhōu ēn lái hòu huǐ
南充针|nán chōng zhēn
生命树的分叉|shēng mìng shù de fēn chā
罗干|luō gān
敬请忍|jìng qǐng rěn
上海市劳动和社会保障局违规使用社保资金|shàng hǎi shì láo dòng hé shè huì bǎo zhàng jú wéi guī shǐ yòng shè bǎo zī jīn
丁关根|dīng guān gēn
新华通论坛|xīn huá tōng lùn tán
姜春云|jiāng chūn yún
何新|hé xīn
邵琪伟|shào qí wěi
丝诱|sī yòu
女上门|nǚ shàng mén
蜜液|mì yè
血染的风采|xiě rǎn de fēng cǎi
资格證|zī gé zhèng
普萘洛尔|pǔ nài luò ěr
军用手|jūn yòng shǒu
情妹妹|qíng mèi mèi
流亡|liú wáng
亂倫|luàn lún
燕南评论|yàn nán píng lùn
卖身|mài shēn
陈川平|chén chuān píng
加了服|jiā le fú
一九八九年|yī jiǔ bā jiǔ nián
地震预测|dì zhèn yù cè
霸餐|bà cān
朱容基|zhū róng jī
清純壆|qīng chún bó
江氏政治委员|jiāng shì zhèng zhì wěi yuán
人民真实报告|rén mín zhēn shí bào gào
大揭露|dà jiē lù
全家死光|quán jiā sǐ guāng
王光亚|wáng guāng yà
制作简易弓弩|zhì zuò jiǎn yì gōng nǔ
韩长赋|hán cháng fù
政坛明日之星|zhèng tán míng rì zhī xīng
低制|dī zhì
法lun功|fǎ lungōng
刘晓波|liú xiǎo bō
用友移动|yòng yǒu yí dòng
王奉友|wáng fèng yǒu
孙金龙|sūn jīn lóng
朱溶剂|zhū róng jì
富婆给废|fù pó gěi fèi
许达哲|xǔ dá zhé
89学潮大屠杀|89xué cháo dà tú shā
私房写真|sī fáng xiě zhēn
九.评|jiǔ .píng
来福猎|lái fú liè
代办制|dài bàn zhì
地磅解码器|dì bàng jiě mǎ qì
品香堂|pǐn xiāng táng
安门事|ān mén shì
中共领导人黑幕|zhōng gòng lǐng dǎo rén hēi mù
法轮佛法|fǎ lún fó fǎ
钦定接班人|qīn dìng jiē bān rén
陈敏尔|chén mǐn ěr
中国共和党|zhōng guó gòng hé dǎng
骚穴|sāo xué
炸弹配方|zhà dàn pèi fāng
傅锐|fù ruì
40万名车车主名单|40wàn míng chē chē zhǔ míng dān
台海危机|tái hǎi wēi jī
冰火佳|bīng huǒ jiā
信用卡套现|xìn yòng qiǎ tào xiàn
木牛流马的污染比汽车飞机大|mù niú liú mǎ de wū rǎn bǐ qì chē fēi jī dà
鼓动一些|gǔ dòng yī xiē
军刀军刺甩棍|jūn dāo jūn cì shuǎi gùn
三二二攻台作战|sān èr èr gōng tái zuò zhàn
風花|fēng huā
先烈纷纷|xiān liè fēn fēn
代写论文|dài xiě lùn wén
仿品军刺出售|fǎng pǐn jūn cì chū shòu
第1代领导|dì 1dài lǐng dǎo
龙虎豹宋书元|lóng hǔ bào sòng shū yuán
成人聊|chéng rén liáo
香港独立|xiāng gǎng dú lì
罢教|bà jiào
温家宝|wēn jiā bǎo
薛伟|xuē wěi
黑庄|hēi zhuāng
杨怀安|yáng huái ān
拉开水晶|lā kāi shuǐ jīng
内射|nèi shè
珐.輪功|fà .lún gōng
售麻醉|shòu má zuì
分家在|fēn jiā zài
指纹考勤|zhǐ wén kǎo qín
社会混|shè huì hùn
闳志|hóng zhì
供应麻醉箭批发|gōng yìng má zuì jiàn pī fā
第一代领导|dì yī dài lǐng dǎo
猎枪麻醉枪钢珠枪|liè qiāng má zuì qiāng gāng zhū qiāng
中南海高层权利斗争|zhōng nán hǎi gāo céng quán lì dǒu zhēng
主席像|zhǔ xí xiàng
武吉海|wǔ jí hǎi
曹建明|cáo jiàn míng
法论功|fǎ lùn gōng
斐得勒|fěi dé lè
发生关系|fā shēng guān xì
东突厥斯坦伊斯兰|dōng tū jué sī tǎn yī sī lán
遭武警|zāo wǔ jǐng
平反六四|píng fǎn liù sì
轻舟快讯|qīng zhōu kuài xùn
可塑炸弹制作方法|kě sù zhà dàn zhì zuò fāng fǎ
宇宙大法|yǔ zhòu dà fǎ
刘建华|liú jiàn huá
拉登说|lā dēng shuō
黑手党|hēi shǒu dǎng
恐怖份子|kǒng bù fèn zǐ
反社会|fǎn shè huì
恐怖分子傻瓜手册|kǒng bù fēn zǐ shǎ guā shǒu cè
刘晓竹|liú xiǎo zhú
维汉|wéi hàn
中共独裁|zhōng gòng dú cái
学生妹|xué shēng mèi
洪吟|hóng yín
麻醉枪猎枪军用|má zuì qiāng liè qiāng jūn yòng
五套功|wǔ tào gōng
唐人|táng rén
蟆叫专家|má jiào zhuān jiā
屁眼|pì yǎn
和狗交|hé gǒu jiāo
法纶|fǎ lún
中华人民实话实说|zhōng huá rén mín shí huà shí shuō
大嘴歌|dà zuǐ gē
王伟|wáng wěi
特价|tè jià
供铲党|gōng chǎn dǎng
激光汽|jī guāng qì
大紀元|dà jì yuán
找援交|zhǎo yuán jiāo
黑火药的制作|hēi huǒ yào de zhì zuò
藏西|cáng xī
大奶子|dà nǎi zǐ
土炸药成份|tǔ zhà yào chéng fèn
千禧弘法|qiān xǐ hóng fǎ
毕业证书样本|bì yè zhèng shū yáng běn
跪真相|guì zhēn xiāng
益受贿|yì shòu huì
蔡振华|cài zhèn huá
克劳塞维茨|kè láo sāi wéi cí
法西斯|fǎ xī sī
女伟哥|nǚ wěi gē
民運|mín yùn
透视眼睛|tòu shì yǎn jīng
小电影|xiǎo diàn yǐng
少女迷情粉货到付款|shǎo nǚ mí qíng fěn huò dào fù kuǎn
一丝不挂|yī sī bù guà
平惨案|píng cǎn àn
少儿不宜|shǎo ér bù yí
清华帮|qīng huá bāng
贱比|jiàn bǐ
孟建柱|mèng jiàn zhù
发仑da发|fā lún dafā
教你怎么用土办法做武器|jiào nǐ zěn me yòng tǔ bàn fǎ zuò wǔ qì
肉穴|ròu xué
炸弹遥控|zhà dàn yáo kòng
盐酸曲|yán suān qū
穴口|xué kǒu
老虎机|lǎo hǔ jī
阿扁|ā biǎn
激情电话|jī qíng diàn huà
究生答案|jiū shēng dá àn
台湾独立|tái wān dú lì
简易导弹制作|jiǎn yì dǎo dàn zhì zuò
天安门事件|tiān ān mén shì jiàn
志洪李|zhì hóng lǐ
人民大会堂|rén mín dà huì táng
粪青|fèn qīng
法抡功|fǎ lún gōng
人民真实报道|rén mín zhēn shí bào dào
彩票选号机|cǎi piào xuǎn hào jī
乙酸三乙基锡|yǐ suān sān yǐ jī xí
地铁十号线塌方|dì tiě shí hào xiàn tā fāng
僵贼民|jiāng zéi mín
江系人马|jiāng xì rén mǎ
调查婚外情|diào chá hūn wài qíng
蜜穴|mì xué
各类文凭|gè lèi wén píng
十六大|shí liù dà
做爱小|zuò ài xiǎo
网上赚钱|wǎng shàng zhuàn qián
江祸心|jiāng huò xīn
中央召开北戴河会议决定十八大高层人事|zhōng yāng zhào kāi běi dài hé huì yì jué dìng shí bā dà gāo céng rén shì
亚情|yà qíng
当官要精|dāng guān yào jīng
点数优惠|diǎn shù yōu huì
现在的警察|xiàn zài de jǐng chá
发情|fā qíng
东方红时空|dōng fāng hóng shí kōng
售三棱|shòu sān léng
禅密功|shàn mì gōng
色电影|sè diàn yǐng
台海问题|tái hǎi wèn tí
麻将透|má jiāng tòu
母子乱伦|mǔ zǐ luàn lún
国家妓|guó jiā jì
擠乳汁|jǐ rǔ zhī
無修正|wú xiū zhèng
裸聊|luǒ liáo
8.18事件|8.18shì jiàn
卫星广播器材|wèi xīng guǎng bō qì cái
败培训|bài péi xùn
军转干部|jūn zhuǎn gān bù
本.拉登|běn .lā dēng
袁纯清|yuán chún qīng
泽d|zé d
雷管|léi guǎn
中国高层人事变动解读|zhōng guó gāo céng rén shì biàn dòng jiě dú
感扑克|gǎn pū kè
抿主|mǐn zhǔ
zemin|zemin
你的西域|nǐ de xī yù
郑义|zhèng yì
中石油国家电网倒数|zhōng shí yóu guó jiā diàn wǎng dǎo shù
贾廷安|jiǎ tíng ān
宋祖英|sòng zǔ yīng
东复活|dōng fù huó
躲猫猫|duǒ māo māo
万人大签名|wàn rén dà qiān míng
江氏家族|jiāng shì jiā zú
熊炎|xióng yán
反华|fǎn huá
屙民|ē mín
南大自由论坛|nán dà zì yóu lùn tán
驶你母|shǐ nǐ mǔ
弓弩有限公司|gōng nǔ yǒu xiàn gōng sī
死刑现场|sǐ xíng xiàn cháng
法論|fǎ lùn
蒋公纪念歌|jiǎng gōng jì niàn gē
欧泽高|ōu zé gāo
才知道只生|cái zhī dào zhǐ shēng
夏川纯|xià chuān chún
尚福林|shàng fú lín
砝仑|fá lún
理做帐报|lǐ zuò zhàng bào
藏獨|cáng dú
硒藏|xī cáng
铅弹|qiān dàn
公开信胡书记空中民主墙|gōng kāi xìn hú shū jì kōng zhōng mín zhǔ qiáng
卫留成|wèi liú chéng
仙鹤气枪出售|xiān hè qì qiāng chū shòu
朱镕基|zhū róng jī
商业楼|shāng yè lóu
党的官|dǎng de guān
甲流了|jiǎ liú le
胡下台|hú xià tái
私家侦探|sī jiā zhēn tàn
东森新闻网|dōng sēn xīn wén wǎng
胡江曾|hú jiāng céng
天葬|tiān zàng
暴動|bào dòng
南华早报|nán huá zǎo bào
中国复兴论坛|zhōng guó fù xīng lùn tán
罢工门|bà gōng mén
罗斯小姐|luō sī xiǎo jiě
色情网站|sè qíng wǎng zhàn
暴力袭警|bào lì xí jǐng
连发手|lián fā shǒu
程铁军|chéng tiě jūn
考试机构|kǎo shì jī gōu
分裂|fēn liè
色诱|sè yòu
李洪峰|lǐ hóng fēng
yin荡|yindàng
杜世成|dù shì chéng
支持台湾独立|zhī chí tái wān dú lì
购买自爆材料|gòu mǎi zì bào cái liào
头双管|tóu shuāng guǎn
陈训秋|chén xùn qiū
彭枫|péng fēng
硝铵|xiāo ān
刘永川|liú yǒng chuān
特别党费|tè bié dǎng fèi
論攻|lùn gōng
北京之春民主论坛|běi jīng zhī chūn mín zhǔ lùn tán
挤乳汁|jǐ rǔ zhī
吴毓萍|wú yù píng
群体性事|qún tǐ xìng shì
韩东方|hán dōng fāng
发伦|fā lún
三二二攻台作战计划|sān èr èr gōng tái zuò zhàn jì huá
士康事件|shì kāng shì jiàn
89年春夏之交|89nián chūn xià zhī jiāo
第7代领导|dì 7dài lǐng dǎo
中南海波澜起伏|zhōng nán hǎi bō lán qǐ fú
登陆台湾|dēng lù tái wān
等人是老|děng rén shì lǎo
隐形耳|yǐn xíng ěr
李学举|lǐ xué jǔ
蝇毒|yíng dú
哪里有气枪卖|nǎ lǐ yǒu qì qiāng mài
发浪|fā làng
沁园春血|qìn yuán chūn xiě
告中国人民解放军广大官兵书|gào zhōng guó rén mín jiě fàng jūn guǎng dà guān bīng shū
抡功|lún gōng
陈小同|chén xiǎo tóng
父母下岗儿下地|fù mǔ xià gǎng ér xià dì
港鑫華|gǎng xīn huá
法谪功|fǎ zhé gōng
警察殴打|jǐng chá ōu dǎ
抽着大中|chōu zháo dà zhōng
聯繫電|lián xì diàn
色妹妹|sè mèi mèi
独立中文笔会|dú lì zhōng wén bǐ huì
天音功|tiān yīn gōng
迷魂药|mí hún yào
乖乖粉|guāi guāi fěn
高息贷款|gāo xī dài kuǎn
血腥清场|xiě xīng qīng cháng
淫荡口交妹|yín dàng kǒu jiāo mèi
机卡密|jī qiǎ mì
蹋纳税|tà nà shuì
木齐针|mù qí zhēn
哲民|zhé mín
磅遥控器|bàng yáo kòng qì
发抡功|fā lún gōng
喜贪赃|xǐ tān zāng
杨周|yáng zhōu
短信商务广告|duǎn xìn shāng wù guǎng gào
考前答|kǎo qián dá
黑逼|hēi bī
袁腾飞|yuán téng fēi
叶青纯|yè qīng chún
反恐委员会|fǎn kǒng wěi yuán huì
新华举报|xīn huá jǔ bào
张纪南|zhāng jì nán
张高丽|zhāng gāo lì
禁网禁片|jìn wǎng jìn piàn
赵氏弓弩专卖店|zhào shì gōng nǔ zhuān mài diàn
中央黑幕|zhōng yāng hēi mù
温家堡|wēn jiā bǎo
用手枪|yòng shǒu qiāng
抢其火炬|qiǎng qí huǒ jù
张左己|zhāng zuǒ jǐ
钱其琛|qián qí chēn
拍肩神药|pāi jiān shén yào
考试联盟|kǎo shì lián méng
国办发|guó bàn fā
輪公|lún gōng
幼交|yòu jiāo
军事委员会|jūn shì wěi yuán huì
迷昏药|mí hūn yào
江x|jiāng x
乙撑亚胺|yǐ chēng yà àn
袁伟民|yuán wěi mín
九十三运动|jiǔ shí sān yùn dòng
邓矮子|dèng ǎi zǐ
火药制作简易炸弹|huǒ yào zhì zuò jiǎn yì zhà dàn
程凯|chéng kǎi
反共|fǎn gòng
张基|zhāng jī
双筒|shuāng tǒng
迷昏藥|mí hūn yào
出售发票|chū shòu fā piào
杨利民|yáng lì mín
氰化钠|qīng huà nà
童屹|tóng yì
夜话紫禁城|yè huà zǐ jìn chéng
捆绑|kǔn bǎng
亚热|yà rè
六四事件|liù sì shì jiàn
穷人|qióng rén
人民大众时事参考|rén mín dà zhòng shí shì cān kǎo
总会美女|zǒng huì měi nǚ
淫娃|yín wá
静坐|jìng zuò
炸药配方与制作|zhà yào pèi fāng yǔ zhì zuò
赵南|zhào nán
瓦斯手|wǎ sī shǒu
福尔马林|fú ěr mǎ lín
Chinaliberal|Chinaliberal
谢小庆|xiè xiǎo qìng
李长才|lǐ cháng cái
迷幻药|mí huàn yào
原味内衣|yuán wèi nèi yī
白志健|bái zhì jiàn
出售外国枪模|chū shòu wài guó qiāng mó
张军|zhāng jūn
刘源|liú yuán
沦攻|lún gōng
瑞士金融大学|ruì shì jīn róng dà xué
江贼民|jiāng zéi mín
赵乐际|zhào lè jì
麻醉弹|má zuì dàn
瘟假饱|wēn jiǎ bǎo
黄康生|huáng kāng shēng
纳米比亚|nà mǐ bǐ yà
手答案|shǒu dá àn
李从军|lǐ cóng jūn
传中共中央关于18大的人事安排意见|chuán zhōng gòng zhōng yāng guān yú 18dà de rén shì ān pái yì jiàn
段桂清|duàn guì qīng
开邓选|kāi dèng xuǎn
胡温|hú wēn
穴图|xué tú
保钓组织|bǎo diào zǔ zhī
中印边界谈判结果|zhōng yìn biān jiè tán pàn jié guǒ
下硝化甘油的制作方法|xià xiāo huà gān yóu de zhì zuò fāng fǎ
中功|zhōng gōng
如何自制燃烧弹|rú hé zì zhì rán shāo dàn
三利达弓弩配件|sān lì dá gōng nǔ pèi jiàn
铃木麻|líng mù má
吾爾開希|wú ěr kāi xī
真实文凭|zhēn shí wén píng
脱衣艳|tuō yī yàn
拍肩醉迷药|pāi jiān zuì mí yào
共产党|gòng chǎn dǎng
C4炸药|C4zhà yào
薄一波|bó yī bō
银行卡复制设备|yín xíng qiǎ fù zhì shè bèi
九、评|jiǔ 、píng
军用弓弩批发|jūn yòng gōng nǔ pī fā
群体性事件|qún tǐ xìng shì jiàn
炸药配|zhà yào pèi
文强|wén qiáng
粉饰太平|fěn shì tài píng
杀毙|shā bì
麻醉枪|má zuì qiāng
四二六社论|sì èr liù shè lùn
王丹|wáng dān
治军方针定调|zhì jūn fāng zhēn dìng diào
采花堂|cǎi huā táng
代追债|dài zhuī zhài
郭伯雄|guō bó xióng
自杀指南|zì shā zhǐ nán
铅弹 上海工字气枪|qiān dàn  shàng hǎi gōng zì qì qiāng
中组部前部长直言|zhōng zǔ bù qián bù cháng zhí yán
情色|qíng sè
循环轮回论|xún huán lún huí lùn
猎枪|liè qiāng
靖国|jìng guó
圣战|shèng zhàn
子弹货到付款|zǐ dàn huò dào fù kuǎn
胡江内斗|hú jiāng nèi dǒu
9.12事件|9.12shì jiàn
义解|yì jiě
策没有不|cè méi yǒu bù
射颜|shè yán
中国官场情杀案|zhōng guó guān cháng qíng shā àn
太王四神|tài wáng sì shén
人体炸弹|rén tǐ zhà dàn
丝袜|sī wà
1989年|1989nián
张筱雨|zhāng xiǎo yǔ
十八大权力变更|shí bā dà quán lì biàn gèng
克千术|kè qiān shù
广场事件|guǎng cháng shì jiàn
导人的最|dǎo rén de zuì
红床|hóng chuáng
基督教|jī dū jiào
bb弹|bbdàn
阳江军品军刀网|yáng jiāng jūn pǐn jūn dāo wǎng
赤裸|chì luǒ
怒的志愿|nù de zhì yuàn
发仑|fā lún
证件办|zhèng jiàn bàn
江Core|jiāng Core
西藏论坛|xī cáng lùn tán
tnt炸药配方|tntzhà yào pèi fāng
底裤|dǐ kù
筏囵|fá lún
yangjia|yangjia
隐形摄像机|yǐn xíng shè xiàng jī
体透视镜|tǐ tòu shì jìng
透视功能|tòu shì gōng néng
售纯度|shòu chún dù
谁是胡的接班人|shuí shì hú de jiē bān rén
蒋经国|jiǎng jīng guó
外围赌球|wài wéi dǔ qiú
素女心|sù nǚ xīn
占领台湾|zhān lǐng tái wān
抵制北京奥运|dǐ zhì běi jīng ào yùn
中共十八大前夕人事布局出手既稳又重|zhōng gòng shí bā dà qián xī rén shì bù jú chū shǒu jì wěn yòu zhòng
胸部|xiōng bù
杨士秋|yáng shì qiū
反党|fǎn dǎng
弓弩免定金货到付款|gōng nǔ miǎn dìng jīn huò dào fù kuǎn
法车仑|fǎ chē lún
援助交际|yuán zhù jiāo jì
炸药出售|zhà yào chū shòu
疆獨|jiāng dú
鸿志|hóng zhì
巨乳|jù rǔ
十7大|shí 7dà
第4代领导|dì 4dài lǐng dǎo
新观察论坛|xīn guān chá lùn tán
假证件|jiǎ zhèng jiàn
提供答案|tí gōng dá àn
八九学|bā jiǔ xué
四川广安|sì chuān guǎng ān
18大|18dà
共贪党|gòng tān dǎng
供应三步倒麻醉箭|gōng yìng sān bù dǎo má zuì jiàn
基本靠吼|jī běn kào hǒu
精子|jīng zǐ
售防身|shòu fáng shēn
唑仑|zuò lún
答an|dá an
任亚平|rèn yà píng
淪公|lún gōng
正见|zhèng jiàn
色友|sè yǒu
不办人事|bù bàn rén shì
肖强|xiào qiáng
出售气枪 QQ|chū shòu qì qiāng  QQ
聊视频|liáo shì pín
龙卷风|lóng juàn fēng
经典谎言|jīng diǎn huǎng yán
机号定|jī hào dìng
出售袖珍手枪|chū shòu xiù zhēn shǒu qiāng
简易炸|jiǎn yì zhà
十八大|shí bā dà
周英|zhōu yīng
西山会议|xī shān huì yì
符贵|fú guì
靖志远|jìng zhì yuǎn
短信猫|duǎn xìn māo
慈悲功|cí bēi gōng
亚砷酸钠|yà shēn suān nà
华主席|huá zhǔ xí
论文代写|lùn wén dài xiě
军转|jūn zhuǎn
州三箭|zhōu sān jiàn
贰拾周年|èr shí zhōu nián
王明方|wáng míng fāng
不查都|bù chá dū
特工资|tè gōng zī
天安门|tiān ān mén
王振华|wáng zhèn huá
SIM卡复制器|SIMqiǎ fù zhì qì
郭树清|guō shù qīng
出售蒙汉药|chū shòu méng hàn yào
胎盘|tāi pán
岳武|yuè wǔ
苏家屯集|sū jiā tún jí
四川大地震异象揭密|sì chuān dà dì zhèn yì xiàng jiē mì
六代接班人|liù dài jiē bān rén
黄色小电影|huáng sè xiǎo diàn yǐng
疯狂掠夺大陆股民|fēng kuáng lvè duó dà lù gǔ mín
性高潮|xìng gāo cháo
逢9必乱|féng 9bì luàn
饭岛爱|fàn dǎo ài
陆同修|lù tóng xiū
金书波|jīn shū bō
阿拉伯|ā lā bó
习近平|xí jìn píng
回教|huí jiào
要射精了|yào shè jīng le
解放tw|jiě fàng tw
屠光绍|tú guāng shào
债务公司|zhài wù gōng sī
马馼|mǎ wén
天鹅之旅|tiān é zhī lǚ
慧聪|huì cōng
易达网络卡|yì dá wǎng luò qiǎ
我们自杀吧|wǒ men zì shā ba
乳头|rǔ tóu
国家级省级正规期刊|guó jiā jí shěng jí zhèng guī qī kān
反测速雷|fǎn cè sù léi
常劲|cháng jìng
中国舆论监督网周洪|zhōng guó yú lùn jiān dū wǎng zhōu hóng
高自联|gāo zì lián
秦光荣|qín guāng róng
专业代理|zhuān yè dài lǐ
代办证件|dài bàn zhèng jiàn
妈逼|mā bī
政治字眼（如两岸关系等）|zhèng zhì zì yǎn （rú liǎng àn guān xì děng ）
大纪元新闻网|dà jì yuán xīn wén wǎng
中央日报|zhōng yāng rì bào
等人老百|děng rén lǎo bǎi
教养院|jiào yǎng yuàn
中共十八热门人选|zhōng gòng shí bā rè mén rén xuǎn
杨建利|yáng jiàn lì
骑单车出|qí dān chē chū
枪货到|qiāng huò dào
中国户外刀具网|zhōng guó hù wài dāo jù wǎng
李岚清|lǐ lán qīng
沙漠之鹰|shā mò zhī yīng
肛门|gāng mén
口技|kǒu jì
党的喉舌|dǎng de hóu shé
流血事件|liú xiě shì jiàn
藏du|cáng du
共产党的末日|gòng chǎn dǎng de mò rì
菱恝|líng jiá
自烧|zì shāo
淫术炼金士|yín shù liàn jīn shì
国wu院|guó wuyuàn
大史|dà shǐ
艳舞|yàn wǔ
9评|9píng
侵犯国外专利|qīn fàn guó wài zhuān lì
幸运码|xìng yùn mǎ
远志明|yuǎn zhì míng
春水横溢|chūn shuǐ héng yì
北京政坛清华名人|běi jīng zhèng tán qīng huá míng rén
奥你妈的运|ào nǐ mā de yùn
罂粟籽|yīng sù zǐ
出售军刺军刀|chū shòu jūn cì jūn dāo
李洪宽|lǐ hóng kuān
第三次世界大战|dì sān cì shì jiè dà zhàn
强烈抗议中共当局|qiáng liè kàng yì zhōng gòng dāng jú
陆封锁|lù fēng suǒ
枪手队|qiāng shǒu duì
津大地震|jīn dà dì zhèn
弓弩特许经销|gōng nǔ tè xǔ jīng xiāo
涉嫌抄袭|shè xián chāo xí
黄色|huáng sè
冯寿淼|féng shòu miǎo
322攻台作战计划|322gōng tái zuò zhàn jì huá
垡轮|fá lún
氧化二丁基锡|yǎng huà èr dīng jī xí
独夫民贼|dú fū mín zéi
气狗出售 进口气狗|qì gǒu chū shòu  jìn kǒu qì gǒu
色情电影|sè qíng diàn yǐng
对日强硬|duì rì qiáng yìng
万维读者论坛|wàn wéi dú zhě lùn tán
毒蛇钻|dú shé zuàn
王国生|wáng guó shēng
弹劾|dàn hé
艾斯海提·克里木拜|ài sī hǎi tí ·kè lǐ mù bài
手枪|阻击枪|shǒu qiāng |zǔ jí qiāng
集团出售手枪气枪|jí tuán chū shòu shǒu qiāng qì qiāng
传说的胡曾联手是一种假象|chuán shuō de hú céng lián shǒu shì yī zhǒng jiǎ xiàng
远程遥控解码|yuǎn chéng yáo kòng jiě mǎ
插阴|chā yīn
模型枪|mó xíng qiāng
防卫刀具直销网|fáng wèi dāo jù zhí xiāo wǎng
淫贱|yín jiàn
数据中国|shù jù zhōng guó
徐水良|xú shuǐ liáng
李幛喆|lǐ zhàng zhé
王若望|wáng ruò wàng
阴b|yīn b
64时期|64shí qī
郭金龙|guō jīn lóng
暴政|bào zhèng
lihongzhi|lihongzhi
公产党|gōng chǎn dǎng
天安门屠杀|tiān ān mén tú shā
项小吉|xiàng xiǎo jí
江贼民.江折民|jiāng zéi mín .jiāng zhé mín
骚水|sāo shuǐ
民抗议|mín kàng yì
自由亚州|zì yóu yà zhōu
假証|jiǎ zhèng
警方包庇|jǐng fāng bāo bì
裸体|luǒ tǐ
透视药|tòu shì yào
贱人|jiàn rén
老习|lǎo xí
野营开山刀军刺|yě yíng kāi shān dāo jūn cì
童世平|tóng shì píng
广州军区|guǎng zhōu jūn qū
中国正义党|zhōng guó zhèng yì dǎng
色欲|sè yù
全金属仿真枪专卖|quán jīn shǔ fǎng zhēn qiāng zhuān mài
菊爆|jú bào
王益案|wáng yì àn
国家软弱|guó jiā ruǎn ruò
垡沦|fá lún
长狗|cháng gǒu
制作炸弹首先要|zhì zuò zhà dàn shǒu xiān yào
气枪/出售/专卖网|qì qiāng /chū shòu /zhuān mài wǎng
迫害|pò hài
发票出|fā piào chū
成人片|chéng rén piàn
党内权争|dǎng nèi quán zhēng
高丽棒子|gāo lì bàng zǐ
伦理毛|lún lǐ máo
满狗|mǎn gǒu
欲望|yù wàng
海访民|hǎi fǎng mín
黄晶|huáng jīng
盛华仁|shèng huá rén
嫩逼|nèn bī
阿拉法特|ā lā fǎ tè
温切斯特|wēn qiē sī tè
出售枪支|chū shòu qiāng zhī
89学潮血腥屠杀|89xué cháo xiě xīng tú shā
要说法|yào shuō fǎ
贡挡|gòng dǎng
郭庚茂|guō gēng mào
香烟迷药|xiāng yān mí yào
国色天香网|guó sè tiān xiāng wǎng
张庆伟|zhāng qìng wěi
华惠棋|huá huì qí
李成玉|lǐ chéng yù
九风|jiǔ fēng
十八大接班人|shí bā dà jiē bān rén
迷奸药出售|mí jiān yào chū shòu
中国人民党|zhōng guó rén mín dǎng
在家里做原子弹|zài jiā lǐ zuò yuán zǐ dàn
松岛枫|sōng dǎo fēng
江绵康|jiāng mián kāng
毛时代大饥荒揭秘|máo shí dài dà jī huāng jiē mì
炸药的成分|zhà yào de chéng fēn
温jia宝|wēn jiabǎo
铁观音产地茶|tiě guān yīn chǎn dì chá
倫攻|lún gōng
售热武|shòu rè wǔ
郑源|zhèng yuán
航空|háng kōng
换届隐忧|huàn jiè yǐn yōu
朱之鑫|zhū zhī xīn
拉姆斯菲尔德|lā mǔ sī fēi ěr dé
宋爱荣|sòng ài róng
猎枪仿真枪QQ|liè qiāng fǎng zhēn qiāng QQ
垡抡|fá lún
法倫|fǎ lún
阀沦|fá lún
徐天亮|xú tiān liàng
江主席|jiāng zhǔ xí
提前预测|tí qián yù cè
放尿|fàng niào
亚硒酸氢钠|yà xī suān qīng nà
人木又|rén mù yòu
胡的接班人|hú de jiē bān rén
香港彩|xiāng gǎng cǎi
张伟国|zhāng wěi guó
反封锁|fǎn fēng suǒ
操黑|cāo hēi
产党共|chǎn dǎng gòng
燃烧瓶的制作方法|rán shāo píng de zhì zuò fāng fǎ
全国两会|quán guó liǎng huì
贪污腐败|tān wū fǔ bài
檀鑫|tán xīn
美乳|měi rǔ
特供|tè gōng
蒋公|jiǎng gōng
法轮工|fǎ lún gōng
出售步枪|chū shòu bù qiāng
新疆叛|xīn jiāng pàn
吹萧|chuī xiāo
福娃的預|fú wá de yù
拍肩迷药出售|pāi jiān mí yào chū shòu
王旭东|wáng xù dōng
刀具直销网|dāo jù zhí xiāo wǎng
幼齿类|yòu chǐ lèi
新唐人电视台|xīn táng rén diàn shì tái
骂四川|mà sì chuān
钢针狗|gāng zhēn gǒu
疆独藏独|jiāng dú cáng dú
安拉|ān lā
70天大事记|70tiān dà shì jì
雪山狮子|xuě shān shī zǐ
党内言事潮|dǎng nèi yán shì cháo
浪逼|làng bī
自制手枪|zì zhì shǒu qiāng
胡耀邦|hú yào bāng
陆兵|lù bīng
台wan|tái wan
乙硼烷|yǐ péng wán
消防队|xiāo fáng duì
余欣荣|yú xīn róng
成人小|chéng rén xiǎo
脱裤门|tuō kù mén
王希哲|wáng xī zhé
王润生|wáng rùn shēng
高勤荣|gāo qín róng
胡紧套|hú jǐn tào
屠杀|tú shā
李遠哲|lǐ yuǎn zhé
六氟化铀|liù fú huà yóu
漫步丝|màn bù sī
垡伦|fá lún
夕樹舞子|xī shù wǔ zǐ
购买枪支QQ|gòu mǎi qiāng zhī QQ
中国人权|zhōng guó rén quán
字牌汽|zì pái qì
民殇|mín shāng
傅成玉|fù chéng yù
著名精品折刀出售|zhù míng jīng pǐn zhé dāo chū shòu
高官互调|gāo guān hù diào
中央派系斗争|zhōng yāng pài xì dǒu zhēng
出售炸药QQ|chū shòu zhà yào QQ
亡共者胡|wáng gòng zhě hú
姐痛|jiě tòng
成人图|chéng rén tú
胡泽君|hú zé jūn
中俄边界|zhōng é biān jiè
天府广场集会|tiān fǔ guǎng cháng jí huì
赵氏弓弩专卖网|zhào shì gōng nǔ zhuān mài wǎng
反雷达测|fǎn léi dá cè
替人体|tì rén tǐ
招鸡|zhāo jī
大妓院|dà jì yuàn
席临终前|xí lín zhōng qián
邮件群发|yóu jiàn qún fā
官商勾结|guān shāng gōu jié
枪销售|qiāng xiāo shòu
联大|lián dà
微型摄像|wēi xíng shè xiàng
炸弹制作手册 硫酸|zhà dàn zhì zuò shǒu cè  liú suān
自制手枪哪里买|zì zhì shǒu qiāng nǎ lǐ mǎi
起爆器|qǐ bào qì
亚洲自由之声|yà zhōu zì yóu zhī shēng
催眠水|cuī mián shuǐ
守所死法|shǒu suǒ sǐ fǎ
集体淫|jí tǐ yín
豪圈钱|háo quān qián
激情小电影|jī qíng xiǎo diàn yǐng
一部分人因年龄或健康原因将不得不退下去|yī bù fēn rén yīn nián líng huò jiàn kāng yuán yīn jiāng bù dé bù tuì xià qù
古怪歌|gǔ guài gē
宇宙真理|yǔ zhòu zhēn lǐ
淘宝气枪货到付款|táo bǎo qì qiāng huò dào fù kuǎn
新势力|xīn shì lì
防卫电棍出售|fáng wèi diàn gùn chū shòu
在线播放|zài xiàn bō fàng
新中华战记|xīn zhōng huá zhàn jì
容弹量|róng dàn liàng
金麟岂是池中物|jīn lín qǐ shì chí zhōng wù
刘宾深|liú bīn shēn
三浦愛佳|sān pǔ ài jiā
乏轮|fá lún
昆仑女神功|kūn lún nǚ shén gōng
反革命|fǎn gé mìng
维多利亚公园|wéi duō lì yà gōng yuán
封杀|fēng shā
姐上门|jiě shàng mén
砝纶|fá lún
自己找枪|zì jǐ zhǎo qiāng
清官团|qīng guān tuán
协晃悠|xié huǎng yōu
王太华|wáng tài huá
阳江刀具批发网|yáng jiāng dāo jù pī fā wǎng
魏新生|wèi xīn shēng
中共恐惧|zhōng gòng kǒng jù
唐柏桥|táng bǎi qiáo
烟感器|yān gǎn qì
阀伦|fá lún
中俄边界新约|zhōng é biān jiè xīn yuē
重亚硒酸钠|zhòng yà xī suān nà
魏礼群|wèi lǐ qún
成人文学|chéng rén wén xué
导叫失|dǎo jiào shī
沈昌功|shěn chāng gōng
中国媒体十大事件|zhōng guó méi tǐ shí dà shì jiàn
自制炸药方法|zì zhì zhà yào fāng fǎ
醉迷药|zuì mí yào
江氏政治局|jiāng shì zhèng zhì jú
麻服散|má fú sàn
考后付款|kǎo hòu fù kuǎn
操死|cāo sǐ
无界浏览器|wú jiè liú lǎn qì
垡论|fá lùn
惩公安|chéng gōng ān
浓精|nóng jīng
因毒硫磷|yīn dú liú lín
公投|gōng tóu
西藏限|xī cáng xiàn
热比娅|rè bǐ yà
亲美|qīn měi
中共权利斗争|zhōng gòng quán lì dǒu zhēng
政腐|zhèng fǔ
乙酸汞|yǐ suān gǒng
觉醒的中国公民日渐清楚地认识到|jué xǐng de zhōng guó gōng mín rì jiàn qīng chǔ dì rèn shì dào
北方先锋军刀|běi fāng xiān fēng jūn dāo
阀抡|fá lún
抗暴|kàng bào
操屄自慰器|cāo bī zì wèi qì
助考网|zhù kǎo wǎng
专制政权|zhuān zhì zhèng quán
王正福|wáng zhèng fú
邓小平和他的儿子|dèng xiǎo píng hé tā de ér zǐ
刘宾雁|liú bīn yàn
恩格斯|ēn gé sī
江罗|jiāng luō
亚硒酸二钠|yà xī suān èr nà
弓弩专卖店网|gōng nǔ zhuān mài diàn wǎng
程真|chéng zhēn
号屏蔽器|hào píng bì qì
全球最大的华人视聊|quán qiú zuì dà de huá rén shì liáo
练功群众|liàn gōng qún zhòng
王胜俊|wáng shèng jùn
砝抡|fá lún
罗保铭|luō bǎo míng
清场内幕|qīng cháng nèi mù
围攻警|wéi gōng jǐng
北高联|běi gāo lián
无界浏览|wú jiè liú lǎn
流血冲突|liú xiě chōng tū
中共权力斗争|zhōng gòng quán lì dǒu zhēng
卡宾枪|qiǎ bīn qiāng
枪的参|qiāng de cān
原子弹DIY教程|yuán zǐ dàn DIYjiào chéng
这不是天灾|zhè bù shì tiān zāi
64大屠杀|64dà tú shā
出售气枪 电话|chū shòu qì qiāng  diàn huà
信访局|xìn fǎng jú
消防隊|xiāo fáng duì
凌锋|líng fēng
统独论坛|tǒng dú lùn tán
冯敏刚|féng mǐn gāng
气枪货到付款,汽狗出售|qì qiāng huò dào fù kuǎn ,qì gǒu chū shòu
纪念达赖喇嘛流亡49周年|jì niàn dá lài lǎ ma liú wáng 49zhōu nián
回民暴|huí mín bào
改号软件|gǎi hào ruǎn jiàn
白军|bái jūn
九码|jiǔ mǎ
沈彤|shěn tóng
台办|tái bàn
火药的配方|huǒ yào de pèi fāng
中国太子|zhōng guó tài zǐ
藏暴乱|cáng bào luàn
酒像喝汤|jiǔ xiàng hē tāng
拱铲|gǒng chǎn
隐瞒地震|yǐn mán dì zhèn
等屁民|děng pì mín
吴仁华|wú rén huá
插B|chā B
考前预测|kǎo qián yù cè
宗教压迫|zōng jiào yā pò
一氧化汞|yī yǎng huà gǒng
加拿大皇家骑警|jiā ná dà huáng jiā qí jǐng
基地组织|jī dì zǔ zhī
刘文胜|liú wén shèng
任于斯国|rèn yú sī guó
西点军刀网|xī diǎn jūn dāo wǎng
无人性的政权|wú rén xìng de zhèng quán
美国军刀出售|měi guó jūn dāo chū shòu
苍山兰|cāng shān lán
吴定富|wú dìng fù
610洗脑班|610xǐ nǎo bān
试题答案|shì tí dá àn
汪岷|wāng mín
找枪手|zhǎo qiāng shǒu
台完|tái wán
足交|zú jiāo
关卓中|guān zhuō zhōng
台海局势|tái hǎi jú shì
还会吹萧|huán huì chuī xiāo
国际投注|guó jì tóu zhù
党禁|dǎng jìn
特贡|tè gòng
政治局常委|zhèng zhì jú cháng wěi
赵铁锤|zhào tiě chuí
反中共黑色暴力|fǎn zhōng gòng hēi sè bào lì
醉乙醚|zuì yǐ mí
咨讯紫阳|zī xùn zǐ yáng
种公务员|zhǒng gōng wù yuán
全家死绝|quán jiā sǐ jué
喷尿|pēn niào
类准确答|lèi zhǔn què dá
提供专业及时的气狗|tí gōng zhuān yè jí shí de qì gǒu
政治局十八|zhèng zhì jú shí bā
严家其|yán jiā qí
领导干部吃王八|lǐng dǎo gān bù chī wáng bā
黄华华|huáng huá huá
宋书元|sòng shū yuán
中共封锁|zhōng gòng fēng suǒ
银行联合管理局|yín xíng lián hé guǎn lǐ jú
呋塞米|fū sāi mǐ
普京|pǔ jīng
赵品潞|zhào pǐn lù
印章|yìn zhāng
儿园凶|ér yuán xiōng
王刚|wáng gāng
李买富|lǐ mǎi fù
性奴集中营|xìng nú jí zhōng yíng
高压狗QQ|gāo yā gǒu QQ
天怒|tiān nù
白春礼|bái chūn lǐ
找政法委副|zhǎo zhèng fǎ wěi fù
毛片|máo piàn
封从德|fēng cóng dé
诱奸|yòu jiān
型手枪|xíng shǒu qiāng
高强|gāo qiáng
夜激情|yè jī qíng
台湾共合国|tái wān gòng hé guó
回汉冲突|huí hàn chōng tū
弓弩网|gōng nǔ wǎng
足球玩法|zú qiú wán fǎ
一党专制|yī dǎng zhuān zhì
麻醉钢枪|má zuì gāng qiāng
九成|jiǔ chéng
爱国者同盟|ài guó zhě tóng méng
三利达弓弩专卖网|sān lì dá gōng nǔ zhuān mài wǎng
燃烧瓶制作|rán shāo píng zhì zuò
姐包夜|jiě bāo yè
海军部署|hǎi jūn bù shǔ
惨奥|cǎn ào
平反|píng fǎn
国之母|guó zhī mǔ
考设备|kǎo shè bèi
性感妖娆|xìng gǎn yāo rǎo
婊子|biǎo zǐ
土共|tǔ gòng
求肾|qiú shèn
神的教会|shén de jiào huì
李纪恒|lǐ jì héng
航空售票|háng kōng shòu piào
温加宝|wēn jiā bǎo
娱乐透视|yú lè tòu shì
h动漫|hdòng màn
短信投票业务|duǎn xìn tóu piào yè wù
黄冰|huáng bīng
列确|liè què
工力|gōng lì
公开信胡|gōng kāi xìn hú
逼奸|bī jiān
西独|xī dú
陈绍基|chén shào jī
女教師|nǚ jiào shī
办理证件|bàn lǐ zhèng jiàn
浑圆豪乳|hún yuán háo rǔ
海luo因|hǎi luoyīn
性虐|xìng nuè
一切证件|yī qiē zhèng jiàn
散弹枪|sàn dàn qiāng
信用卡|xìn yòng qiǎ
邪党|xié dǎng
异氰酸甲酯|yì qīng suān jiǎ zhǐ
斯诺|sī nuò
泰兴幼|tài xīng yòu
处男|chù nán
原装弹|yuán zhuāng dàn
孔摄像|kǒng shè xiàng
家元自称玉皇大帝|jiā yuán zì chēng yù huáng dà dì
远程偷拍|yuǎn chéng tōu pāi
华通时事论坛|huá tōng shí shì lùn tán
芳香型智悟气功|fāng xiāng xíng zhì wù qì gōng
发票代理|fā piào dài lǐ
江主|jiāng zhǔ
转法轮|zhuǎn fǎ lún
流血事|liú xiě shì
讨伐中宣部|tǎo fá zhōng xuān bù
温宝宝|wēn bǎo bǎo
抽着芙蓉|chōu zháo fú róng
警察说保|jǐng chá shuō bǎo
淫母|yín mǔ
麻醉枪出售可验货|má zuì qiāng chū shòu kě yàn huò
门徒会|mén tú huì
狗杂种|gǒu zá zhǒng
机定位器|jī dìng wèi qì
宋楚瑜|sòng chǔ yú
刘华清|liú huá qīng
黑火药比例|hēi huǒ yào bǐ lì
h漫|hmàn
拦截器|lán jié qì
筏仑|fá lún
激情电影|jī qíng diàn yǐng
李继耐|lǐ jì nài
士的年|shì de nián
当官靠后台|dāng guān kào hòu tái
士的宁|shì de níng
sm女王|smnǚ wáng
电狗|diàn gǒu
厕奴|cè nú
促性腺激素|cù xìng xiàn jī sù
核弹头的制造|hé dàn tóu de zhì zào
炸药的制作配方|zhà yào de zhì zuò pèi fāng
后穴|hòu xué
反对共产党|fǎn duì gòng chǎn dǎng
共王储|gòng wáng chǔ
杀害学生|shā hài xué shēng
款到发货|kuǎn dào fā huò
违禁品|wéi jìn pǐn
梁擎墩|liáng qíng dūn
法*功|fǎ *gōng
纯度黄|chún dù huáng
富民穷|fù mín qióng
出售假币|chū shòu jiǎ bì
钟山风雨论坛|zhōng shān fēng yǔ lùn tán
四小码|sì xiǎo mǎ
江z民|jiāng zmín
张文中|zhāng wén zhōng
供应精品弓弩|gōng yìng jīng pǐn gōng nǔ
新生网|xīn shēng wǎng
裤袜|kù wà
鸽派|gē pài
供应秦氏弓弩|gōng yìng qín shì gōng nǔ
高薪养廉|gāo xīn yǎng lián
臧人|zāng rén
武侯祠|wǔ hóu cí
康跳楼|kāng tiào lóu
狼友|láng yǒu
刺刀专卖网|cì dāo zhuān mài wǎng
肉唇|ròu chún
手机卡复制器|shǒu jī qiǎ fù zhì qì
淫妇|yín fù
地震哥|dì zhèn gē
浑圆|hún yuán
屈万祥|qū wàn xiáng
战术军刀出售|zhàn shù jūn dāo chū shòu
张丕林|zhāng pī lín
社会黑暗|shè huì hēi àn
梓健特药|zǐ jiàn tè yào
大麻树脂|dà má shù zhī
周恩来忏悔|zhōu ēn lái chàn huǐ
淫水|yín shuǐ
色色|sè sè
中共党文化|zhōng gòng dǎng wén huà
老人政治|lǎo rén zhèng zhì
四川朱昱|sì chuān zhū yù
双管立|shuāng guǎn lì
法某功|fǎ mǒu gōng
烧公安局|shāo gōng ān jú
张春贤|zhāng chūn xián
爱女人|ài nǚ rén
18高官互调|18gāo guān hù diào
高莺莺|gāo yīng yīng
汉芯造假|hàn xīn zào jiǎ
三个呆婊|sān gè dāi biǎo
丝足按|sī zú àn
张中伟|zhāng zhōng wěi
18届中央|18jiè zhōng yāng
告洋状|gào yáng zhuàng
弓弩专卖网|gōng nǔ zhuān mài wǎng
伐抡|fá lún
刘奇葆热门人选|liú qí bǎo rè mén rén xuǎn
防卫刀具军品网|fáng wèi dāo jù jūn pǐn wǎng
升达毕业证|shēng dá bì yè zhèng
诺查丹玛斯|nuò chá dān mǎ sī
政治局十七|zhèng zhì jú shí qī
万里大造林|wàn lǐ dà zào lín
史久武|shǐ jiǔ wǔ
布卖淫女|bù mài yín nǚ
活体取肾|huó tǐ qǔ shèn
香功|xiāng gōng
网络警察|wǎng luò jǐng chá
杨月清|yáng yuè qīng
中国弓弩狩猎网|zhōng guó gōng nǔ shòu liè wǎng
论公|lùn gōng
發倫|fā lún
招妓|zhāo jì
东方微点|dōng fāng wēi diǎn
转法论|zhuǎn fǎ lùn
学运|xué yùn
蒙古独|méng gǔ dú
傻逼|shǎ bī
珐论|fà lùn
妇销魂|fù xiāo hún
私家侦探服务|sī jiā zhēn tàn fú wù
华莱士|huá lái shì
李向东|lǐ xiàng dōng
毛泽东复活|máo zé dōng fù huó
民储害|mín chǔ hài
三步倒麻醉弩箭销售|sān bù dǎo má zuì nǔ jiàn xiāo shòu
形式主义|xíng shì zhǔ yì
全裸|quán luǒ
王东明|wáng dōng míng
群体事件|qún tǐ shì jiàn
组织集体|zǔ zhī jí tǐ
輪攻|lún gōng
乙酸甲氧基乙基汞|yǐ suān jiǎ yǎng jī yǐ jī gǒng
傅怡彬|fù yí bīn
中特|zhōng tè
冲锋枪|chōng fēng qiāng
检查部|jiǎn chá bù
开苞|kāi bāo
袜按摩|wà àn mó
代办发票|dài bàn fā piào
杜冷丁|dù lěng dīng
一党执政|yī dǎng zhí zhèng
钓鱼岛|diào yú dǎo
中共反腐风暴大背景揭秘|zhōng gòng fǎn fǔ fēng bào dà bèi jǐng jiē mì
话在肉身显现|huà zài ròu shēn xiǎn xiàn
罢运|bà yùn
陪考枪|péi kǎo qiāng
化学扫盲|huà xué sǎo máng
死法分布|sǐ fǎ fēn bù
投毒杀人|tóu dú shā rén
严家祺|yán jiā qí
剖腹一刀五千几|pōu fù yī dāo wǔ qiān jī
眼角膜|yǎn jiǎo mò
屄|bī
普通嘌|pǔ tōng piāo
三个代表|sān gè dài biǎo
卢越刚|lú yuè gāng
网络推广扩散器|wǎng luò tuī guǎng kuò sàn qì
奈美|nài měi
炸药的制|zhà yào de zhì
朱维群|zhū wéi qún
李红痔|lǐ hóng zhì
西藏独立|xī cáng dú lì
玉穴|yù xué
等级證|děng jí zhèng
体健貌端|tǐ jiàn mào duān
格证考试|gé zhèng kǎo shì
换肾|huàn shèn
谭作人|tán zuò rén
中国当局|zhōng guó dāng jú
塑胶炸弹|sù jiāo zhà dàn
汪兆钧|wāng zhào jūn
王新宪|wáng xīn xiàn
个人圆满说|gè rén yuán mǎn shuō
手柄制作炸弹引爆器|shǒu bǐng zhì zuò zhà dàn yǐn bào qì
大乳|dà rǔ
权威主义国家的合法性理论|quán wēi zhǔ yì guó jiā de hé fǎ xìng lǐ lùn
杨焕宁|yáng huàn níng
讨说法|tǎo shuō fǎ
刘冬冬|liú dōng dōng
无毛|wú máo
公开小姐|gōng kāi xiǎo jiě
世界通|shì jiè tōng
卫星电视|wèi xīng diàn shì
东洲|dōng zhōu
阿宾|ā bīn
刘石泉|liú shí quán
防身武器手枪|fáng shēn wǔ qì shǒu qiāng
香港总彩|xiāng gǎng zǒng cǎi
性福情|xìng fú qíng
国库折|guó kù zhé
哪里有连发猎枪买卖|nǎ lǐ yǒu lián fā liè qiāng mǎi mài
政治人祸的源头|zhèng zhì rén huò de yuán tóu
跑官要官|pǎo guān yào guān
娥眉气枪出售|é méi qì qiāng chū shòu
乐透码|lè tòu mǎ
台湾猪|tái wān zhū
白立朴|bái lì pǔ
尚勇|shàng yǒng
朱总理|zhū zǒng lǐ
平小邓|píng xiǎo dèng
答案卫星接收机|dá àn wèi xīng jiē shōu jī
售五四|shòu wǔ sì
六合采|liù hé cǎi
土枪|tǔ qiāng
情趣用品|qíng qù yòng pǐn
ze民|zemín
章虹|zhāng hóng
王沪|wáng hù
售狗子|shòu gǒu zǐ
中南海|zhōng nán hǎi
追风弓弩麻醉箭专卖|zhuī fēng gōng nǔ má zuì jiàn zhuān mài
阳具|yáng jù
阴蒂|yīn dì
中国弓弩直销|zhōng guó gōng nǔ zhí xiāo
机枪|jī qiāng
朱琳|zhū lín
江哥|jiāng gē
陈国令|chén guó lìng
高干子女|gāo gān zǐ nǚ
星岛日报|xīng dǎo rì bào
六四信息|liù sì xìn xī
加油机干扰器|jiā yóu jī gān rǎo qì
发轮功陈果|fā lún gōng chén guǒ
解放台湾|jiě fàng tái wān
原子弹制作方法DIY|yuán zǐ dàn zhì zuò fāng fǎ DIY
温加饱|wēn jiā bǎo
丁元|dīng yuán
手狗|shǒu gǒu
反对党|fǎn duì dǎng
抗议|kàng yì
高压气枪|气枪货到付款|gāo yā qì qiāng |qì qiāng huò dào fù kuǎn
出售炸药 电话|chū shòu zhà yào  diàn huà
九凭|jiǔ píng
不要沉默|bù yào chén mò
气狗|qì gǒu
于大海|yú dà hǎi
党校安插亲信|dǎng xiào ān chā qīn xìn
《开心》|《kāi xīn 》
引起暴动|yǐn qǐ bào dòng
八九六四|bā jiǔ liù sì
本公司担|běn gōng sī dàn
最淫官员|zuì yín guān yuán
通信维权|tōng xìn wéi quán
冰毒|bīng dú
考试枪|kǎo shì qiāng
手机跟|shǒu jī gēn
冯东海|féng dōng hǎi
一夜激情|yī yè jī qíng
中国海外腐败兵团|zhōng guó hǎi wài fǔ bài bīng tuán
言被劳教|yán bèi láo jiào
鸡尾酒炸弹制作|jī wěi jiǔ zhà dàn zhì zuò
吴玉良|wú yù liáng
切腹|qiē fù
华过锋|huá guò fēng
炸药配方|zhà yào pèi fāng
转让猎枪|zhuǎn ràng liè qiāng
透视眼镜|tòu shì yǎn jìng
生肖中特|shēng xiào zhōng tè
女任职名|nǚ rèn zhí míng
封面女郎|fēng miàn nǚ láng
李汉柏|lǐ hàn bǎi
幽谷三|yōu gǔ sān
情杀|qíng shā
阴阜|yīn fù
民一主|mín yī zhǔ
拍肩型|pāi jiān xíng
人员安排|rén yuán ān pái
法轮义|fǎ lún yì
陈雷|chén léi
纹了毛|wén le máo
董万才|dǒng wàn cái
万法归一功|wàn fǎ guī yī gōng
炮的小蜜|pào de xiǎo mì
商务短信|shāng wù duǎn xìn
丁香社|dīng xiāng shè
開碼|kāi mǎ
冰在火上|bīng zài huǒ shàng
车用电子狗|chē yòng diàn zǐ gǒu
高瞻|gāo zhān
陆独|lù dú
王华元|wáng huá yuán
姜洪禄|jiāng hóng lù
野营砍刀户外军刀|yě yíng kǎn dāo hù wài jūn dāo
邓可人|dèng kě rén
穆罕默德|mù hǎn mò dé
九ping|jiǔ ping
陰道|yīn dào
胡主席|hú zhǔ xí
寻找林昭的灵魂|xún zhǎo lín zhāo de líng hún
骆琳|luò lín
八九民|bā jiǔ mín
开锁工具|kāi suǒ gōng jù
吴方城|wú fāng chéng
廖晖|liào huī
卖血|mài xiě
军用品|jūn yòng pǐn
论坛|lùn tán
张岱梨|zhāng dài lí
王维林|wáng wéi lín
共产党的报应|gòng chǎn dǎng de bào yìng
調教|diào jiào
中国支配下的朝鲜经济|zhōng guó zhī pèi xià de zhāo xiān jīng jì
刘振起|liú zhèn qǐ
尹庆民|yǐn qìng mín
新语丝|xīn yǔ sī
裸照|luǒ zhào
新疆限|xīn jiāng xiàn
维权基|wéi quán jī
刘学普|liú xué pǔ
哪能买到真枪|nǎ néng mǎi dào zhēn qiāng
式粉推|shì fěn tuī
氧化汞|yǎng huà gǒng
巴赫|bā hè
前阴后庭抽插自慰器|qián yīn hòu tíng chōu chā zì wèi qì
叫自慰|jiào zì wèi
曾庆红|céng qìng hóng
学潮|xué cháo
安魂网|ān hún wǎng
白黄牙签|bái huáng yá qiān
王传平|wáng chuán píng
淫糜|yín mí
军用弓弩专卖网|jūn yòng gōng nǔ zhuān mài wǎng
江折民|jiāng zhé mín
老虎机上分器|lǎo hǔ jī shàng fēn qì
李源潮|lǐ yuán cháo
大家论坛|dà jiā lùn tán
BB弹|BBdàn
理想信念斗争|lǐ xiǎng xìn niàn dǒu zhēng
大肉棒|dà ròu bàng
北京黑幕|běi jīng hēi mù
我就色|wǒ jiù sè
法轮公|fǎ lún gōng
慰安妇|wèi ān fù
爆炸|bào zhà
修炼|xiū liàn
出售军刀|chū shòu jūn dāo
现在的政府|xiàn zài de zhèng fǔ
政治反对派|zhèng zhì fǎn duì pài
日本万岁|rì běn wàn suì
出售手枪 QQ|chū shòu shǒu qiāng  QQ
18预测|18yù cè
中华时事|zhōng huá shí shì
蒋介石|jiǎng jiè shí
隐形喷剂|yǐn xíng pēn jì
xing伴侣|xingbàn lǚ
中日没有不友好的|zhōng rì méi yǒu bù yǒu hǎo de
江毒|jiāng dú
党产共|dǎng chǎn gòng
杜导斌|dù dǎo bīn
针刺事|zhēn cì shì
露b|lù b
潮吹|cháo chuī
盘古乐队|pán gǔ lè duì
办理真实|bàn lǐ zhēn shí
盛雪|shèng xuě
草莓牛奶|cǎo méi niú nǎi
东南西北论谈|dōng nán xī běi lùn tán
打砸抢|dǎ zá qiǎng
预测答案|yù cè dá àn
大赦国际|dà shè guó jì
华国|huá guó
捍卫社会主义共和国|hàn wèi shè huì zhǔ yì gòng hé guó
武藤蘭|wǔ téng lán
乏仑|fá lún
陈至立|chén zhì lì
乱伦类|luàn lún lèi
亚洲周刊|yà zhōu zhōu kān
蔡崇国|cài chóng guó
做台|zuò tái
胡晓炼|hú xiǎo liàn
军用77出售|jūn yòng 77chū shòu
狂插|kuáng chā
哈狗帮|hā gǒu bāng
淫穴|yín xué
顶花心|dǐng huā xīn
匕首|bǐ shǒu
一党独裁|yī dǎng dú cái
五套功法|wǔ tào gōng fǎ
治疗肿瘤|zhì liáo zhǒng liú
挺胡|tǐng hú
倒陈运动的最大受益人|dǎo chén yùn dòng de zuì dà shòu yì rén
卖国|mài guó
少女迷奸药水|shǎo nǚ mí jiān yào shuǐ
幼女|yòu nǚ
张耕|zhāng gēng
胸罩|xiōng zhào
于浩成|yú hào chéng
售枪购买手枪|shòu qiāng gòu mǎi shǒu qiāng
暴干|bào gān
遗情书|yí qíng shū
卖枪|mài qiāng
贺国强|hè guó qiáng
色盟|sè méng
有偿服务|yǒu cháng fú wù
龙湾事件|lóng wān shì jiàn
点金商务|diǎn jīn shāng wù
江泽民|jiāng zé mín
当局严密封锁|dāng jú yán mì fēng suǒ
中国民主党联合总部|zhōng guó mín zhǔ dǎng lián hé zǒng bù
扫了爷爷|sǎo le yé yé
小澤園|xiǎo zé yuán
秘书长|mì shū cháng
dl喇嘛|dllǎ ma
乔石|qiáo shí
張五常|zhāng wǔ cháng
王荣|wáng róng
制作性能优良的燃烧弹|zhì zuò xìng néng yōu liáng de rán shāo dàn
领导忽悠百姓叫号召|lǐng dǎo hū yōu bǎi xìng jiào hào zhào
穿透仪器|chuān tòu yí qì
发财诗|fā cái shī
李小琳|lǐ xiǎo lín
震其国土|zhèn qí guó tǔ
警车雷达|jǐng chē léi dá
三分钟教你原子弹|sān fēn zhōng jiào nǐ yuán zǐ dàn
弓弩商城|gōng nǔ shāng chéng
党政一把手|dǎng zhèng yī bǎ shǒu
朱容鸡|zhū róng jī
言论罪|yán lùn zuì
现在的社会|xiàn zài de shè huì
短信平台|duǎn xìn píng tái
传九退三|chuán jiǔ tuì sān
李三共志|lǐ sān gòng zhì
二十四事件|èr shí sì shì jiàn
中南海权力斗争|zhōng nán hǎi quán lì dǒu zhēng
抽插仿真器具|chōu chā fǎng zhēn qì jù
反社会主义|fǎn shè huì zhǔ yì
中央军委|zhōng yāng jūn wěi
东突厥斯坦|dōng tū jué sī tǎn
不查全|bù chá quán
陈宣良|chén xuān liáng
西藏人民大起义运动|xī cáng rén mín dà qǐ yì yùn dòng
中共黑帮|zhōng gòng hēi bāng
文化大革命|wén huà dà gé mìng
金正日|jīn zhèng rì
三箭气枪出售|sān jiàn qì qiāng chū shòu
欲火|yù huǒ
PK黑社会|PKhēi shè huì
发票代开|fā piào dài kāi
三级片|sān jí piàn
导小商|dǎo xiǎo shāng
孙思敬|sūn sī jìng
全范围教会|quán fàn wéi jiào huì
抗议磁悬浮|kàng yì cí xuán fú
毛贼东|máo zéi dōng
朱金基|zhū jīn jī
包过|bāo guò
游精佑|yóu jīng yòu
赛克网|sài kè wǎng
香港一类|xiāng gǎng yī lèi
龟头|guī tóu
手淫|shǒu yín
王晓初|wáng xiǎo chū
巴音|bā yīn
魔难论|mó nán lùn
各类考试|gè lèi kǎo shì
三級|sān jí
察象蚂|chá xiàng mǎ
李法泉|lǐ fǎ quán
骚女|sāo nǚ
回忆六四|huí yì liù sì
台湾狗|tái wān gǒu
烧瓶的|shāo píng de
朱瑟里诺|zhū sè lǐ nuò
人体炸弹制作流程|rén tǐ zhà dàn zhì zuò liú chéng
反对日本介入中国铁路工业|fǎn duì rì běn jiè rù zhōng guó tiě lù gōng yè
闵维方|mǐn wéi fāng
婊子养的|biǎo zǐ yǎng de
三股势力|sān gǔ shì lì
反分裂|fǎn fēn liè
东森电视|dōng sēn diàn shì
FL功|FLgōng
售军用|shòu jūn yòng
中国弓弩专卖网|zhōng guó gōng nǔ zhuān mài wǎng
氵去车仑工力|氵 qù chē lún gōng lì
集体腐|jí tǐ fǔ
精装|jīng zhuāng
猫眼工具|māo yǎn gōng jù
韩正降职副市长|hán zhèng jiàng zhí fù shì cháng
无线耳机|wú xiàn ěr jī
帝国之梦|dì guó zhī mèng
庆红|qìng hóng
中国在统一问题上的投降主义|zhōng guó zài tǒng yī wèn tí shàng de tóu jiàng zhǔ yì
买卖64狗|mǎi mài 64gǒu
级答案|jí dá àn
李金城|lǐ jīn chéng
法能功|fǎ néng gōng
炸弹教|zhà dàn jiào
红满堂|hóng mǎn táng
六4|liù 4
何勇|hé yǒng
康日新|kāng rì xīn
反奥|fǎn ào
易志熹|yì zhì xī
恙虫病|yàng chóng bìng
期刊征稿|qī kān zhēng gǎo
斑蝥|bān máo
油行|yóu xíng
去中央|qù zhōng yāng
情自拍|qíng zì pāi
弟痛|dì tòng
喂奶门|wèi nǎi mén
电击枪|diàn jí qiāng
跟踪器|gēn zōng qì
原子弹配方|yuán zǐ dàn pèi fāng
供应麻醉箭|gōng yìng má zuì jiàn
郑中|zhèng zhōng
胡江风云|hú jiāng fēng yún
洪志|hóng zhì
明慧网|míng huì wǎng
情妇|qíng fù
18届委员|18jiè wěi yuán
爽死|shuǎng sǐ
翟渠|zhái qú
食精|shí jīng
垡仑|fá lún
林黄菊|lín huáng jú
淫叫|yín jiào
跟帖器|gēn tiē qì
李刚|lǐ gāng
拉丹|lā dān
女被人家搞|nǚ bèi rén jiā gǎo
性交|xìng jiāo
劳动教养所|láo dòng jiào yǎng suǒ
李伟信的笔供|lǐ wěi xìn de bǐ gōng
教你制作原子弹|jiào nǐ zhì zuò yuán zǐ dàn
明斯克号|míng sī kè hào
18大人事变动|18dà rén shì biàn dòng
自由网|zì yóu wǎng
愚民政|yú mín zhèng
付申奇|fù shēn qí
王政|wáng zhèng
售枪支|shòu qiāng zhī
麻醉槍|má zuì qiāng
飞扬论坛|fēi yáng lùn tán
领事馆|lǐng shì guǎn
暴淫|bào yín
春宫图|chūn gōng tú
志不愿跟|zhì bù yuàn gēn
收复台湾|shōu fù tái wān
气枪仿真枪出售|qì qiāng fǎng zhēn qiāng chū shòu
炸yao|zhà yao
杨利伟|yáng lì wěi
safeweb|safeweb
公安网监|gōng ān wǎng jiān
气狗 高压气枪|qì gǒu  gāo yā qì qiāng
空军部署|kōng jūn bù shǔ
逢九必乱|féng jiǔ bì luàn
亢议|kàng yì
出售火枪 –游戏|chū shòu huǒ qiāng  –yóu xì
北大校园BBS|běi dà xiào yuán BBS
军刀图片砍刀|jūn dāo tú piàn kǎn dāo
欧广源|ōu guǎng yuán
麻黄草|má huáng cǎo
有华龙|yǒu huá lóng
弘志|hóng zhì
政治犯|zhèng zhì fàn
地奈德|dì nài dé
伪火|wěi huǒ
乌蝇水|wū yíng shuǐ
精子射在|jīng zǐ shè zài
发论功|fā lùn gōng
血洗京城|xiě xǐ jīng chéng
贱货|jiàn huò
军长发威|jūn cháng fā wēi
黄树贤|huáng shù xián
就要色|jiù yào sè
雷春美|léi chūn měi
张平|zhāng píng
多黨|duō dǎng
台军|tái jūn
资料泄|zī liào xiè
关闭所有论坛|guān bì suǒ yǒu lùn tán
全真证|quán zhēn zhèng
功友|gōng yǒu
空難|kōng nán
维权谈|wéi quán tán
行长王益|xíng cháng wáng yì
肉具|ròu jù
zz炸弹的制作方法|zzzhà dàn de zhì zuò fāng fǎ
發論|fā lùn
做爱|zuò ài
第六代领导|dì liù dài lǐng dǎo
弟大物勃|dì dà wù bó
现在的党|xiàn zài de dǎng
赌球网|dǔ qiú wǎng
原子能机构|yuán zǐ néng jī gōu
简易核弹头的制造|jiǎn yì hé dàn tóu de zhì zào
夜总会|yè zǒng huì
官因发帖|guān yīn fā tiē
中南海恩仇录|zhōng nán hǎi ēn chóu lù
内裤|nèi kù
袁家军|yuán jiā jūn
解体中共|jiě tǐ zhōng gòng
邓爷爷转|dèng yé yé zhuǎn
两会新闻|liǎng huì xīn wén
性感|xìng gǎn
致胡书记的公开信|zhì hú shū jì de gōng kāi xìn
萨斯病|sà sī bìng
红色贵族|hóng sè guì zú
赵洪祝|zhào hóng zhù
治疗乙肝|zhì liáo yǐ gān
援藏网|yuán cáng wǎng
天安门母亲|tiān ān mén mǔ qīn
秦晋|qín jìn
动乱|dòng luàn
张毅|zhāng yì
奸杀|jiān shā
發輪|fā lún
國內美|guó nèi měi
凯他敏|kǎi tā mǐn
成人网站|chéng rén wǎng zhàn
中国高层权力斗争|zhōng guó gāo céng quán lì dǒu zhēng
色区|sè qū
进来的罪|jìn lái de zuì
常万全|cháng wàn quán
办证|bàn zhèng
春宫|chūn gōng
黄祸|huáng huò
参拜|cān bài
胡振民|hú zhèn mín
看房|kàn fáng
无网界浏览|wú wǎng jiè liú lǎn
干你娘|gān nǐ niáng
涛一样胡|tāo yī yáng hú
出台|chū tái
网络封锁|wǎng luò fēng suǒ
弓弩麻醉箭|gōng nǔ má zuì jiàn
贷办|dài bàn
激情交友|jī qíng jiāo yǒu
司马璐|sī mǎ lù
自由门|zì yóu mén
范印华|fàn yìn huá
乱伦小|luàn lún xiǎo
女優|nǚ yōu
六四民主运动|liù sì mín zhǔ yùn dòng
性虐待|xìng nuè dài
霰弹|xiàn dàn
赵宪庚|zhào xiàn gēng
特码|tè mǎ
高压气枪|电狗专卖|gāo yā qì qiāng |diàn gǒu zhuān mài
网特|wǎng tè
李月月鸟|lǐ yuè yuè niǎo
色逼|sè bī
胡总|hú zǒng
金扎金|jīn zhā jīn
土炮|tǔ pào
阴茎|yīn jīng
死逼|sǐ bī
赖达|lài dá
李嵐清|lǐ lán qīng
器官贩卖|qì guān fàn mài
淫河|yín hé
日你妈|rì nǐ mā
二乙基酰胺|èr yǐ jī xiān àn
小泽圆|xiǎo zé yuán
乌鲁木齐|wū lǔ mù qí
蒋捷连|jiǎng jié lián
中央政治局|zhōng yāng zhèng zhì jú
处女|chù nǚ
习明泽|xí míng zé
吴学璨|wú xué càn
新疆独立|xīn jiāng dú lì
克透视|kè tòu shì
大力抽送|dà lì chōu sòng
年轻高知团系接班|nián qīng gāo zhī tuán xì jiē bān
两会报道|liǎng huì bào dào
李总理|lǐ zǒng lǐ
成人视|chéng rén shì
国家机密|guó jiā jī mì
发瞟|fā piǎo
性推广歌|xìng tuī guǎng gē
专业助|zhuān yè zhù
不来提不都热西提|bù lái tí bù dū rè xī tí
阀仑|fá lún
杜鹃|dù juān
宋育英|sòng yù yīng
来复枪|lái fù qiāng
金壮龙|jīn zhuàng lóng
中共十八人选|zhōng gòng shí bā rén xuǎn
社保基金会|shè bǎo jī jīn huì
卡辛纳大道和三福大道交界处|qiǎ xīn nà dà dào hé sān fú dà dào jiāo jiè chù
公安错打|gōng ān cuò dǎ
仿真证|fǎng zhēn zhèng
张小洋|zhāng xiǎo yáng
文字獄|wén zì yù
独夫|dú fū
孙晓群|sūn xiǎo qún
高利贷|gāo lì dài
狗草|gǒu cǎo
大纪元|dà jì yuán
何平|hé píng
中华局域网|zhōng huá jú yù wǎng
方舟子|fāng zhōu zǐ
老江|lǎo jiāng
三步倒弩箭专卖|sān bù dǎo nǔ jiàn zhuān mài
性息|xìng xī
广闻|guǎng wén
磅解码器|bàng jiě mǎ qì
打台湾|dǎ tái wān
默罕默德|mò hǎn mò dé
法院|fǎ yuàn
客户端非法字符|kè hù duān fēi fǎ zì fú
吸储|xī chǔ
李大轮子|lǐ dà lún zǐ
作爱|zuò ài
麻醉|má zuì
菊穴|jú xué
陶驷驹|táo sì jū
小猎人弓弩网|xiǎo liè rén gōng nǔ wǎng
社会主义灭亡|shè huì zhǔ yì miè wáng
插暴|chā bào
邓颖超日记|dèng yǐng chāo rì jì
杜德印|dù dé yìn
文学城|wén xué chéng
伦理电影|lún lǐ diàn yǐng
本无码|běn wú mǎ
代血浆|dài xiě jiāng
射精|shè jīng
中国的人权|zhōng guó de rén quán
中国猪|zhōng guó zhū
姜异康|jiāng yì kāng
大学骚乱|dà xué sāo luàn
安装卫星电视|ān zhuāng èi xīng diàn shì
阳江刀具专卖|yáng jiāng dāo jù zhuān mài
高潮|gāo cháo
王莉莉|wáng lì lì
怎么用土办法做武器|zěn me yòng tǔ bàn fǎ zuò wǔ qì
中国弓弩网|zhōng guó gōng nǔ wǎng
朱成虎|zhū chéng hǔ
林明月|lín míng yuè
第五代中共领导人|dì wǔ dài zhōng gòng lǐng dǎo rén
赛后骚|sài hòu sāo
民主潮|mín zhǔ cháo
日逼|rì bī
冲凉死|chōng liáng sǐ
代理发票|dài lǐ fā piào
三硝基甲苯|sān xiāo jī jiǎ běn
可塑炸弹制作|kě sù zhà dàn zhì zuò
移动公司|yí dòng gōng sī
务员考试|wù yuán kǎo shì
【手枪出售】联系电话|【shǒu qiāng chū shòu 】lián xì diàn huà
王忠民|wáng zhōng mín
代開|dài kāi
煽动不明|shān dòng bù míng
人宇特能功|rén yǔ tè néng gōng
财众科技|cái zhòng kē jì
往事并不如烟|wǎng shì bìng bù rú yān
办理本科|bàn lǐ běn kē
叶剑英|yè jiàn yīng
轮公|lún gōng
李小雪|lǐ xiǎo xuě
猫泽东|māo zé dōng
余远辉|yú yuǎn huī
江流氓|jiāng liú máng
转是政府|zhuǎn shì zhèng fǔ
乙酰替硫脲|yǐ xiān tì liú niào
防身手枪QQ|fáng shēn shǒu qiāng QQ
十个预言|shí gè yù yán
北京当局|běi jīng dāng jú
专业弓弩网|zhuān yè gōng nǔ wǎng
群交|qún jiāo
各类军用枪支|gè lèi jūn yòng qiāng zhī
小泽一郎|xiǎo zé yī láng
维派|wéi pài
造爱|zào ài
书办理|shū bàn lǐ
共铲党|gòng chǎn dǎng
江独裁|jiāng dú cái
传送答案|chuán sòng dá àn
九-评|jiǔ -píng
独裁政治|dú cái zhèng zhì
薄格|bó gé
鸡吧|jī ba
色猫|sè māo
李克强|lǐ kè qiáng
港澳办|gǎng ào bàn
裸陪|luǒ péi
红外透视|hóng wài tòu shì
石肖|shí xiào
针孔|zhēn kǒng
急需嫖|jí xū piào
氰化钾|qīng huà jiǎ
赵氏弓弩专卖|zhào shì gōng nǔ zhuān mài
怎么自制燃烧弹|zěn me zì zhì rán shāo dàn
民族矛盾|mín zú máo dùn
毛厕洞|máo cè dòng
催情粉|cuī qíng fěn
哥痛|gē tòng
统一台湾|tǒng yī tái wān
俄罗斯轮盘|é luō sī lún pán
十七大权力争霸战|shí qī dà quán lì zhēng bà zhàn
人肉炸弹|rén ròu zhà dàn
虎头猎|hǔ tóu liè
邵家健|shào jiā jiàn
神州忏悔录|shén zhōu chàn huǐ lù
十八大人事调整|shí bā dà rén shì diào zhěng
惹火身材|rě huǒ shēn cái
印尼伊斯兰祈祷团|yìn ní yī sī lán qí dǎo tuán
阳江刀具军品网|yáng jiāng dāo jù jūn pǐn wǎng
群众冲击|qún zhòng chōng jí
牌技网|pái jì wǎng
诽谤罪|fěi bàng zuì
空和雅典|kōng hé yǎ diǎn
风水宝地|fēng shuǐ bǎo dì
民意论坛|mín yì lùn tán
李鹏|lǐ péng
王沪宁|wáng hù níng
希拉克|xī lā kè
丝袜保|sī wà bǎo
十七大幕|shí qī dà mù
透视器|tòu shì qì
狂插男根胶囊|kuáng chā nán gēn jiāo náng
秘唇|mì chún
操烂|cāo làn
抗议中共当局|kàng yì zhōng gòng dāng jú
办理票据|bàn lǐ piào jù
维汉员|wéi hàn yuán
基督灵恩布道团|jī dū líng ēn bù dào tuán
泄漏的内|xiè lòu de nèi
学chao|xué chao
酒象喝汤|jiǔ xiàng hē tāng
刘文瑜|liú wén yú
穴海|xué hǎi
访问链接|fǎng wèn liàn jiē
张伯笠|zhāng bó lì
木仓|mù cāng
香港论坛|xiāng gǎng lùn tán
中国社会论坛|zhōng guó shè huì lùn tán
UP新势力|UPxīn shì lì
林军|lín jūn
論功|lùn gōng
中国政坛“清华帮”盛极而衰|zhōng guó zhèng tán “qīng huá bāng ”shèng jí ér shuāi
汉维|hàn wéi
田修思|tián xiū sī
兵力部署|bīng lì bù shǔ
异氰酸苯酯|yì qīng suān běn zhǐ
官匪|guān fěi
蒋洁敏|jiǎng jí mǐn
干死你|gān sǐ nǐ
博讯|bó xùn
钱达|qián dá
第二代领导|dì èr dài lǐng dǎo
女奴|nǚ nú
第三代领导|dì sān dài lǐng dǎo
干扰器|gān rǎo qì
装弹甲|zhuāng dàn jiǎ
狩猎弓弩专卖|shòu liè gōng nǔ zhuān mài
京地震|jīng dì zhèn
强权政府|qiáng quán zhèng fǔ
童增|tóng zēng
恶势力插|è shì lì chā
发生暴动|fā shēng bào dòng
据说全民|jù shuō quán mín
双桶|shuāng tǒng
中共十八人事变动|zhōng gòng shí bā rén shì biàn dòng
绑架|bǎng jià
统治术|tǒng zhì shù
大盖帽|dà gài mào
你说我说论坛|nǐ shuō wǒ shuō lùn tán
叫春|jiào chūn
地下钱庄|dì xià qián zhuāng
手把手教你制作原子弹|shǒu bǎ shǒu jiào nǐ zhì zuò yuán zǐ dàn
温休曾退|wēn xiū céng tuì
昼将近|zhòu jiāng jìn
北省委门|běi shěng wěi mén
中年美妇|zhōng nián měi fù
共青团派|gòng qīng tuán pài
王鸿举|wáng hóng jǔ
绿色环保手机|lǜ sè huán bǎo shǒu jī
根浴|gēn yù
偷窥|tōu kuī
车牌隐|chē pái yǐn
反共传单|fǎn gòng chuán dān
大中华论坛|dà zhōng huá lùn tán
王勇|wáng yǒng
中国和平|zhōng guó hé píng
恶搞晚会|è gǎo wǎn huì
乙酰亚砷酸铜|yǐ xiān yà shēn suān tóng
暴力虐待|bào lì nuè dài
帮招人|bāng zhāo rén
乙酸亚铊|yǐ suān yà tā
丽挺丰胸|lì tǐng fēng xiōng
中共第五代|zhōng gòng dì wǔ dài
东方闪电|dōng fāng shǎn diàn
张海阳|zhāng hǎi yáng
北京政权|běi jīng zhèng quán
应子弹|yìng zǐ dàn
天朝特|tiān zhāo tè
中南海的权力游戏|zhōng nán hǎi de quán lì yóu xì
泰晤士报|tài wù shì bào
酱猪媳|jiàng zhū xí
中国问题论坛|zhōng guó wèn tí lùn tán
等人手术|děng rén shǒu shù
宋平一句话|sòng píng yī jù huà
捏弄|niē nòng
曾荫权|céng yìn quán
国统纲领|guó tǒng gāng lǐng
正见网|zhèng jiàn wǎng
与狗性|yǔ gǒu xìng
航空母舰|háng kōng mǔ jiàn
发沦|fā lún
田田桑|tián tián sāng
警匪一家|jǐng fěi yī jiā
王兆国|wáng zhào guó
导的情人|dǎo de qíng rén
宪法法院|xiàn fǎ fǎ yuàn
江姐来电问|jiāng jiě lái diàn wèn
朱德|zhū dé
为了忘却的纪念|wèi le wàng què de jì niàn
集体自杀|jí tǐ zì shā
刘千石|liú qiān shí
包养|bāo yǎng
八九年|bā jiǔ nián
你妈逼|nǐ mā bī
后庭专区|hòu tíng zhuān qū
万人骚动|wàn rén sāo dòng
诚聘网络兼职|chéng pìn wǎng luò jiān zhí
自由亚|zì yóu yà
江八点|jiāng bā diǎn
视解密|shì jiě mì
麻醉弓弩专卖店|má zuì gōng nǔ zhuān mài diàn
胸推|xiōng tuī
互联网审查|hù lián wǎng shěn chá
天安门一代|tiān ān mén yī dài
中国政坛新星中的四大天王|zhōng guó zhèng tán xīn xīng zhōng de sì dà tiān wáng
原子弹制造完全手册|yuán zǐ dàn zhì zào wán quán shǒu cè
胡适眼|hú shì yǎn
偷偷贪|tōu tōu tān
信用卡提现|xìn yòng qiǎ tí xiàn
九龙论坛|jiǔ lóng lùn tán
王通智|wáng tōng zhì
激光气|jī guāng qì
孟学农|mèng xué nóng
筏论|fá lùn
刘胡兰问|liú hú lán wèn
北大三角地论坛|běi dà sān jiǎo dì lùn tán
儿园杀|ér yuán shā
城管暴力执法|chéng guǎn bào lì zhí fǎ
售弹簧刀|shòu dàn huáng dāo
知道64|zhī dào 64
中国教徒|zhōng guó jiào tú
帝国主义|dì guó zhǔ yì
南京军区|nán jīng jūn qū
卖地财政|mài dì cái zhèng
段录定|duàn lù dìng
阀囵|fá lún
希藏|xī cáng
7大军区|7dà jūn qū
国家正规期刊|guó jiā zhèng guī qī kān
刺激|cì jī
特务机构|tè wù jī gōu
18大的人事|18dà de rén shì
省市换班第五代冒起|shěng shì huàn bān dì wǔ dài mào qǐ
推油按|tuī yóu àn
出售跳刀|chū shòu tiào dāo
钱国梁|qián guó liáng
盗撮|dào cuō
军刀军品网|jūn dāo jūn pǐn wǎng
张先玲|zhāng xiān líng
阴部|yīn bù
帮人怀孕|bāng rén huái yùn
代考网|dài kǎo wǎng
规模冲突|guī mó chōng tū
岡本真|gāng běn zhēn
张宏宝|zhāng hóng bǎo
江猪媳|jiāng zhū xí
中共帝国|zhōng gòng dì guó
成人|chéng rén
周小川|zhōu xiǎo chuān
浪穴|làng xué
紅色恐|hóng sè kǒng
恶党|è dǎng
霸工|bà gōng
伐论|fá lùn
法輪|fǎ lún
伐仑|fá lún
卖国唐捷|mài guó táng jié
校鸡|xiào jī
人民内情真相|rén mín nèi qíng zhēn xiāng
韩国狗|hán guó gǒu
学自联|xué zì lián
中國當局|zhōng guó dāng jú
西奘|xī zàng
韶关斗|sháo guān dǒu
司马晋|sī mǎ jìn
韩正|hán zhèng
乙撑氯醇|yǐ chēng lǜ chún
军刀甩棍销售|jūn dāo shuǎi gùn xiāo shòu
敏主|mǐn zhǔ
建国党|jiàn guó dǎng
治疗性病|zhì liáo xìng bìng
极端武力直销网|jí duān wǔ lì zhí xiāo wǎng
代写毕|dài xiě bì
宝在甘肃修|bǎo zài gān sù xiū
丝袜网|sī wà wǎng
出售答案|chū shòu dá àn
海关总署|hǎi guān zǒng shǔ
正规期刊联合征稿|zhèng guī qī kān lián hé zhēng gǎo
性欲|xìng yù
枪手网|qiāng shǒu wǎng
法轮佛|fǎ lún fó
黄片|huáng piàn
陈希同|chén xī tóng
李毅中|lǐ yì zhōng
东京热|dōng jīng rè
奸情|jiān qíng
透视扑克|tòu shì pū kè
肉棍|ròu gùn
代办文|dài bàn wén
福香巴|fú xiāng bā
州惨案|zhōu cǎn àn
国锋|guó fēng
东突厥斯坦伊斯兰运动|dōng tū jué sī tǎn yī sī lán yùn dòng
中国弩弓专卖|zhōng guó nǔ gōng zhuān mài
装枪套|zhuāng qiāng tào
香水型迷奸药|xiāng shuǐ xíng mí jiān yào
六合彩|liù hé cǎi
自杀|zì shā
作各种证|zuò gè zhǒng zhèng
李总统|lǐ zǒng tǒng
法十轮十功|fǎ shí lún shí gōng
聊性|liáo xìng
看JJ|kàn JJ
太子党|tài zǐ dǎng
核蛋|hé dàn
团派|tuán pài
网管办|wǎng guǎn bàn
江泽慧江泽林|jiāng zé huì jiāng zé lín
汪梦飞|wāng mèng fēi
波霸乳交器具|bō bà rǔ jiāo qì jù
无官正|wú guān zhèng
曹康泰|cáo kāng tài
党前干劲|dǎng qián gān jìng
戈扬|gē yáng
红病历|hóng bìng lì
王建军|wáng jiàn jūn
机号卫|jī hào wèi
乌云其木格|wū yún qí mù gé
深喉冰|shēn hóu bīng
符跃兰|fú yuè lán
官逼民反|guān bī mín fǎn
第二首都|dì èr shǒu dū
天安门录影带|tiān ān mén lù yǐng dài
菊花洞|jú huā dòng
供产|gōng chǎn
伪大|wěi dà
领土拿|lǐng tǔ ná
出售警用手铐|仿真枪|chū shòu jǐng yòng shǒu kào |fǎng zhēn qiāng
麻醉藥|má zuì yào
鹿心社|lù xīn shè
ATOM弹制造|ATOMdàn zhì zào
木犀地|mù xī dì
胰岛素样生长因子|yí dǎo sù yáng shēng cháng yīn zǐ
王冠中|wáng guān zhōng
司马仿真枪模型QQ|sī mǎ fǎng zhēn qiāng mó xíng QQ
Fa轮功|Falún gōng
骚逼|sāo bī
神通加持法|shén tōng jiā chí fǎ
代办|dài bàn
妞上门|niū shàng mén
亲共|qīn gòng
刑警|xíng jǐng
凤凰|fèng huáng
法仑|fǎ lún
中共洗脑|zhōng gòng xǐ nǎo
刘山青|liú shān qīng
口交器具|kǒu jiāo qì jù
克林顿|kè lín dùn
地西泮|dì xī pàn
江胡内斗|jiāng hú nèi dǒu
一平|yī píng
拉登|lā dēng
出售手狗|chū shòu shǒu gǒu
劣等人|liè děng rén
众像羔|zhòng xiàng gāo
法0功|fǎ 0gōng
骚妇|sāo fù
煞笔|shā bǐ
郭声琨|guō shēng kūn
军委主席|jūn wěi zhǔ xí
共和国2049|gòng hé guó 2049
KEY_TEXT|KEY_TEXT
短信群发|duǎn xìn qún fā
颜色革命|yán sè gé mìng
真钱斗地|zhēn qián dǒu dì
梅克保|méi kè bǎo
博园区伪|bó yuán qū wěi
九成新|jiǔ chéng xīn
可燃物|kě rán wù
张玉台|zhāng yù tái
伦攻|lún gōng
李四光预测|lǐ sì guāng yù cè
入联|rù lián
李学勇|lǐ xué yǒng
张博涵|zhāng bó hán
中共第六代|zhōng gòng dì liù dài
老毛|lǎo máo
莫洛托夫燃烧弹|mò luò tuō fū rán shāo dàn
防卫刀具专卖|fáng wèi dāo jù zhuān mài
木子论坛|mù zǐ lùn tán
考研考中|kǎo yán kǎo zhōng
政局雾里看花|zhèng jú wù lǐ kàn huā
亲共分子|qīn gòng fēn zǐ
中共高层变动：王兆国将任常委或取代贾庆龄|zhōng gòng gāo céng biàn dòng ：wáng zhào guó jiāng rèn cháng wěi huò qǔ dài jiǎ qìng líng
制幻剂出售|zhì huàn jì chū shòu
天安門|tiān ān mén
江青|jiāng qīng
民族冲突|mín zú chōng tū
四风|sì fēng
周强|zhōu qiáng
圣殿教|shèng diàn jiào
娘西皮|niáng xī pí
吴双战|wú shuāng zhàn
弹药配方|dàn yào pèi fāng
踩踏事|cǎi tà shì
摸胸|mō xiōng
杜青林|dù qīng lín
短信群发器|duǎn xìn qún fā qì
官匪一家|guān fěi yī jiā
达赖喇嘛|dá lài lǎ ma
王立英|wáng lì yīng
针刺|zhēn cì
陈宝生|chén bǎo shēng
台湾青年独立联盟|tái wān qīng nián dú lì lián méng
粮荒|liáng huāng
郭岩华|guō yán huá
李大师|lǐ dà shī
藏妇会|cáng fù huì
邓楠|dèng nán
杨松|yáng sōng
吃精|chī jīng
汤加丽|tāng jiā lì
州大批贪|zhōu dà pī tān
铭记印尼|míng jì yìn ní
民竹|mín zhú
来福枪|lái fú qiāng
如何在家赚钱|rú hé zài jiā zhuàn qián
台海战争|tái hǎi zhàn zhēng
联合国|lián hé guó
弓弩直销|gōng nǔ zhí xiāo
王正伟|wáng zhèng wěi
余英时|yú yīng shí
硝酸铵的简便制取方法|xiāo suān ān de jiǎn biàn zhì qǔ fāng fǎ
中国改革年代政治斗争|zhōng guó gǎi gé nián dài zhèng zhì dǒu zhēng
我的西域|wǒ de xī yù
替考试|tì kǎo shì
周刊纪事|zhōu kān jì shì
民国|mín guó
潜在用户|qián zài yòng hù
左转是政|zuǒ zhuǎn shì zhèng
部是这样|bù shì zhè yáng
攻占台湾|gōng zhān tái wān
请点击进入|qǐng diǎn jí jìn rù
代讨债|dài tǎo zhài
样板间|yáng bǎn jiān
妓女的口号|jì nǚ de kǒu hào
徐敬业|xú jìng yè
男根增长sex吧|nán gēn zēng cháng sexba
华人媒体|huá rén méi tǐ
法维权|fǎ wéi quán
仿真枪QQ|fǎng zhēn qiāng QQ
高校暴乱|gāo xiào bào luàn
中共退党|zhōng gòng tuì dǎng
狮子旗|shī zǐ qí
马时敏|mǎ shí mǐn
自制手弩|zì zhì shǒu nǔ
助考|zhù kǎo
FL大法|FLdà fǎ
一贯道|yī guàn dào
辩词与梦|biàn cí yǔ mèng
红潮谎言录|hóng cháo huǎng yán lù
有偿捐献|yǒu cháng juān xiàn
光学真题|guāng xué zhēn tí
滚圆大乳|gǔn yuán dà rǔ
狗屁专家|gǒu pì zhuān jiā
中华大众|zhōng huá dà zhòng
刘伟平|liú wěi píng
5毛党|5máo dǎng
暴力执法|bào lì zhí fǎ
变态|biàn tài
宏法|hóng fǎ
拳交|quán jiāo
曾培炎|céng péi yán
皇冠投注|huáng guān tóu zhù
热武器QQ|rè wǔ qì QQ
金盾工程|jīn dùn gōng chéng
治疗红斑狼疮|zhì liáo hóng bān láng chuāng
四大舰队|sì dà jiàn duì
徐粉林|xú fěn lín
李晓英|lǐ xiǎo yīng
宇明网|yǔ míng wǎng
珐囵|fà lún
肉茎|ròu jīng
毛zx|máo zx
乏抡|fá lún
避孕膜|bì yùn mò
高爆炸药基本配方|gāo bào zhà yào jī běn pèi fāng
温如春|wēn rú chūn
徐一天|xú yī tiān
集体打砸|jí tǐ dǎ zá
出售汽枪|chū shòu qì qiāng
燃烧剂的简易制备|rán shāo jì de jiǎn yì zhì bèi
打标语|dǎ biāo yǔ
包办色情娱乐服务|bāo bàn sè qíng yú lè fú wù
出售狙击枪|chū shòu jū jí qiāng
太王四神记|tài wáng sì shén jì
认牌绝|rèn pái jué
窃听器|qiè tīng qì
吴弘达|wú hóng dá
催眠迷幻药|cuī mián mí huàn yào
国母|guó mǔ
右转是政|yòu zhuǎn shì zhèng
九评共|jiǔ píng gòng
枪出售|qiāng chū shòu
同盟党|tóng méng dǎng
万晓东|wàn xiǎo dōng
邓笑贫|dèng xiào pín
江宰民|jiāng zǎi mín
x藏|xcáng
锡峰气枪出售|xí fēng qì qiāng chū shòu
苯丙胺|běn bǐng àn
秦银河|qín yín hé
监听器|jiān tīng qì
陷害罪|xiàn hài zuì
SM后庭器具|SMhòu tíng qì jù
小穴|xiǎo xué
泰州幼|tài zhōu yòu
央视内部晚会|yāng shì nèi bù wǎn huì
主席忏|zhǔ xí chàn
张万年|zhāng wàn nián
邓天生|dèng tiān shēng
野营军刀出售|yě yíng jūn dāo chū shòu
江胡|jiāng hú
漠视生命自私到了极点的中共政权|mò shì shēng mìng zì sī dào le jí diǎn de zhōng gòng zhèng quán
康涛杰|kāng tāo jié
江黑心|jiāng hēi xīn
沈昌人体科技|shěn chāng rén tǐ kē jì
青海无上师|qīng hǎi wú shàng shī
贾治邦|jiǎ zhì bāng
着护士的胸|zháo hù shì de xiōng
简易大威力炸弹|jiǎn yì dà wēi lì zhà dàn
母乳家|mǔ rǔ jiā
18届|18jiè
液体炸|yè tǐ zhà
机屏蔽器|jī píng bì qì
卖64手枪|mài 64shǒu qiāng
主席画像|zhǔ xí huà xiàng
美联社|měi lián shè
做人不能太cctv了|zuò rén bù néng tài cctvle
用刀横向切腹|yòng dāo héng xiàng qiē fù
黎阳平|lí yáng píng
周永康|zhōu yǒng kāng
发牌绝|fā pái jué
拍肩神|pāi jiān shén
手工猎刀专卖|shǒu gōng liè dāo zhuān mài
军转安置|jūn zhuǎn ān zhì
台湾共和国|tái wān gòng hé guó
菊门|jú mén
杨思敏|yáng sī mǐn
哈药直销|hā yào zhí xiāo
舒晓琴|shū xiǎo qín
支持zd|zhī chí zd
新疆骚乱|xīn jiāng sāo luàn
刘家义|liú jiā yì
死要见毛|sǐ yào jiàn máo
汽车炸弹制作|qì chē zhà dàn zhì zuò
4事件|4shì jiàn
真钱投注|zhēn qián tóu zhù
信用卡代理|xìn yòng qiǎ dài lǐ
林长盛|lín cháng shèng
邓狗|dèng gǒu
儿园砍|ér yuán kǎn
王炳章|wáng bǐng zhāng
考前密卷|kǎo qián mì juàn
海洋局|hǎi yáng jú
步枪|bù qiāng
电信路|diàn xìn lù
消防枪|xiāo fáng qiāng
供应弓弩|gōng yìng gōng nǔ
销售运动步枪|xiāo shòu yùn dòng bù qiāng
共x党|gòng xdǎng
插逼|chā bī
编成与基地|biān chéng yǔ jī dì
十八大未来|shí bā dà wèi lái
谢选骏|xiè xuǎn jùn
邓质方|dèng zhí fāng
国产av|guó chǎn av
9风|9fēng
李康|lǐ kāng
划老公|huá lǎo gōng
三去车仑|sān qù chē lún
大众真人真事|dà zhòng zhēn rén zhēn shì
小参考|xiǎo cān kǎo
中共邪党|zhōng gòng xié dǎng
一氯丙酮|yī lǜ bǐng tóng
强制捐款|qiáng zhì juān kuǎn
朱明国|zhū míng guó
弹药制造方法|dàn yào zhì zào fāng fǎ
吴百益|wú bǎi yì
江责民|jiāng zé mín
国峰|guó fēng
郭永平|guō yǒng píng
淫声浪语|yín shēng làng yǔ
工字汽狗麻醉枪|gōng zì qì gǒu má zuì qiāng
张定发|zhāng dìng fā
部忙组阁|bù máng zǔ gé
独裁|dú cái
奶子|nǎi zǐ
陈s扁|chén sbiǎn
淫情|yín qíng
组装手枪|zǔ zhuāng shǒu qiāng
向巴平措|xiàng bā píng cuò
刘淇|liú qí
淫色|yín sè
法o功|fǎ ogōng
正品军刺出售|zhèng pǐn jūn cì chū shòu
VOA采访热比娅|VOAcǎi fǎng rè bǐ yà
锋同志|fēng tóng zhì
刘明康|liú míng kāng
中国威胁论|zhōng guó wēi xié lùn
爆你菊|bào nǐ jú
法拉盛|fǎ lā shèng
境外媒体|jìng wài méi tǐ
信接收器|xìn jiē shōu qì
菊暴|jú bào
避孕套|bì yùn tào
洪哲胜|hóng zhé shèng
淫威|yín wēi
星亚网络影视公司|xīng yà wǎng luò yǐng shì gōng sī
亚硒酸镁|yà xī suān měi
弓弩狩猎网|gōng nǔ shòu liè wǎng
中共任用|zhōng gòng rèn yòng
武力镇压|wǔ lì zhèn yā
明慧周报|míng huì zhōu bào
焉荣竹|yān róng zhú
盛行在舞|shèng xíng zài wǔ
石戈|shí gē
廖锡龙|liào xí lóng
国姆|guó mǔ
顶帖器|dǐng tiē qì
东土耳其斯坦|dōng tǔ ěr qí sī tǎn
强奸丸|qiáng jiān wán
折刀砍刀专卖|zhé dāo kǎn dāo zhuān mài
董元辰|dǒng yuán chén
膏药旗|gāo yào qí
买卖警察枪支|mǎi mài jǐng chá qiāng zhī
自主择业|zì zhǔ zé yè
反屏蔽|fǎn píng bì
tnt炸药成分|tntzhà yào chéng fēn
白立忱|bái lì chén
真善忍|zhēn shàn rěn
炸药|zhà yào
燃烧弹的制作方法|rán shāo dàn de zhì zuò fāng fǎ
军刀直刀专卖|jūn dāo zhí dāo zhuān mài
氧化铊|yǎng huà tā
朱保成|zhū bǎo chéng
哥疼|gē téng
尊爵粉|zūn jué fěn
华夏文摘|huá xià wén zhāi
王宪魁|wáng xiàn kuí
反对共产主义|fǎn duì gòng chǎn zhǔ yì
时事参考|shí shì cān kǎo
茳泽民|jiāng zé mín
迷幻型|mí huàn xíng
星崎未來|xīng qí wèi lái
阀论|fá lùn
考试答案|kǎo shì dá àn
周旋|zhōu xuán
证生成器|zhèng shēng chéng qì
针刺死|zhēn cì sǐ
「红烧兔子」大餐|「hóng shāo tù zǐ 」dà cān
美幼|měi yòu
光祖|guāng zǔ
张春桥|zhāng chūn qiáo
江派和胡派|jiāng pài hé hú pài
世界以利亚福音宣教会|shì jiè yǐ lì yà fú yīn xuān jiào huì
户外军刀出售|hù wài jūn dāo chū shòu
猎枪手枪买卖|liè qiāng shǒu qiāng mǎi mài
释欲|shì yù
张晓刚|zhāng xiǎo gāng
火药配方|huǒ yào pèi fāng
气枪|qì qiāng
国家主要部委|guó jiā zhǔ yào bù wěi
吴官正|wú guān zhèng
氢弹手工制作方法|qīng dàn shǒu gōng zhì zuò fāng fǎ
吳邦國|wú bāng guó
买卖军狗|mǎi mài jūn gǒu
令狐安|lìng hú ān
苯巴比妥|běn bā bǐ tuǒ
苏荣|sū róng
出售各类猎狗|chū shòu gè lèi liè gǒu
刻章|kè zhāng
出售军|chū shòu jūn
考答案|kǎo dá àn
刘士贤|liú shì xián
陈存根|chén cún gēn
华盛顿邮报|huá shèng dùn yóu bào
武装镇压|wǔ zhuāng zhèn yā
肉欲|ròu yù
6合彩|6hé cǎi
长期批发|cháng qī pī fā
开放杂志|kāi fàng zá zhì
针孔摄象|zhēn kǒng shè xiàng
幼齿|yòu chǐ
破处|pò chù
民办大学联合招生|mín bàn dà xué lián hé zhāo shēng
贯通两极法|guàn tōng liǎng jí fǎ
张钢|zhāng gāng
正义党论坛|zhèng yì dǎng lùn tán
吾尔开希|wú ěr kāi xī
泰兴镇中|tài xīng zhèn zhōng
供铲裆|gōng chǎn dāng
第一批下海经商的人富|dì yī pī xià hǎi jīng shāng de rén fù
朱嘉明|zhū jiā míng
双管平|shuāng guǎn píng
王为璐|wáng wèi lù
自由圣|zì yóu shèng
涉台政局|shè tái zhèng jú
黄菊|huáng jú
叶冬松|yè dōng sōng
乙酸铊|yǐ suān tā
民告官|mín gào guān
王玉普|wáng yù pǔ
曹刚川|cáo gāng chuān
忙爱国|máng ài guó
封锁消息|fēng suǒ xiāo xī
反party|fǎn party
枪决现场|qiāng jué xiàn cháng
切听器|qiē tīng qì
珐(工力)学|fà (gōng lì )xué
摊牌要权|tān pái yào quán
政府无能|zhèng fǔ wú néng
自动跳刀专卖|zì dòng tiào dāo zhuān mài
门安天|mén ān tiān
狩猎器材弓弩|shòu liè qì cái gōng nǔ
郭炎炎|guō yán yán
淫媚|yín mèi
成人游戏|chéng rén yóu xì
豆腐渣|dòu fǔ zhā
三水法轮|sān shuǐ fǎ lún
垡囵|fá lún
委坐船|wěi zuò chuán
涂运普|tú yùn pǔ
党鞭|dǎng biān
下贱|xià jiàn
江氏集团|jiāng shì jí tuán
王千源|wáng qiān yuán
鞭满|biān mǎn
语音传送|yǔ yīn chuán sòng
懂文华|dǒng wén huá
中共当局|zhōng gòng dāng jú
李海峰|lǐ hǎi fēng
售信用|shòu xìn yòng
鄧小平|dèng xiǎo píng
法正乾|fǎ zhèng gān
胡锦淘|hú jǐn táo
刘青|liú qīng
李文斌|lǐ wén bīn
罚沦|fá lún
蒙汗药出售|méng hàn yào chū shòu
费良勇|fèi liáng yǒng
地下教会|dì xià jiào huì
氧化亚铊|yǎng huà yà tā
化骨水|huà gǔ shuǐ
爆zha|bào zha
管制刀具|guǎn zhì dāo jù
胡海清|hú hǎi qīng
制作火药配方|zhì zuò huǒ yào pèi fāng
玉蒲团|yù pú tuán
王志刚|wáng zhì gāng
中国网通|zhōng guó wǎng tōng
弓弩亲兄弟货到付款|gōng nǔ qīn xiōng dì huò dào fù kuǎn
枪械|qiāng xiè
姜大明|jiāng dà míng
92式手枪出售|92shì shǒu qiāng chū shòu
夜半加税|yè bàn jiā shuì
强奸|qiáng jiān
手槍买卖自制手枪|shǒu qiāng mǎi mài zì zhì shǒu qiāng
咏妓|yǒng jì
喷精|pēn jīng
露毛|lù máo
洗脑班|xǐ nǎo bān
焦焕成|jiāo huàn chéng
十八等|shí bā děng
赌具|dǔ jù
邝锦文|kuàng jǐn wén
诚加盟|chéng jiā méng
人民报讯|rén mín bào xùn
三唑仑|sān zuò lún
龙虎斗|lóng hǔ dǒu
台du|tái du
无码|wú mǎ
证件公司|zhèng jiàn gōng sī
分众|fēn zhòng
超常科学|chāo cháng kē xué
国际法院|guó jì fǎ yuàn
两限房|liǎng xiàn fáng
出售炸药|chū shòu zhà yào
恶搞人民币|è gǎo rén mín bì
迷藥|mí yào
安眠藥|ān mián yào
王建平|wáng jiàn píng
济南军区|jì nán jūn qū
共铲|gòng chǎn
啦沙|la shā
言论自由|yán lùn zì yóu
张汝成|zhāng rǔ chéng
发囵|fā lún
迷药|mí yào
赵克石|zhào kè shí
人民真实|rén mín zhēn shí
观音法门|guān yīn fǎ mén
刀林荫|dāo lín yìn
蒲团|pú tuán
北京军区|běi jīng jūn qū
苏树林|sū shù lín
操B|cāo B
实际神|shí jì shén
恐怖主义|kǒng bù zhǔ yì
聂卫国|niè wèi guó
暗访包|àn fǎng bāo
示wei|shì wei
我日你|wǒ rì nǐ
高官子女|gāo guān zǐ nǚ
林幼芳|lín yòu fāng
中国社会进步党|zhōng guó shè huì jìn bù dǎng
祁建|qí jiàn
一位老同志的谈话|yī wèi lǎo tóng zhì de tán huà
傅志寰|fù zhì huán
独立台湾|dú lì tái wān
迷情药|mí qíng yào
KC提示|KCtí shì
中国社会的艾滋病|zhōng guó shè huì de ài zī bìng
奸成瘾|jiān chéng yǐn
炼大法|liàn dà fǎ
田罢工|tián bà gōng
速效迷奸药|sù xiào mí jiān yào
前凸后翘|qián tū hòu qiáo
阎明复|yán míng fù
不思四化|bù sī sì huà
商务快车|shāng wù kuài chē
第四代领导|dì sì dài lǐng dǎo
狗娘养的|gǒu niáng yǎng de
论文代发|lùn wén dài fā
九学|jiǔ xué
高压气枪专卖店|gāo yā qì qiāng zhuān mài diàn
毛主席的嫡孙|máo zhǔ xí de dí sūn
三级|sān jí
城管灭|chéng guǎn miè
销售气手狗|xiāo shòu qì shǒu gǒu
江驴|jiāng lǘ
记签|jì qiān
正帮通信公司|zhèng bāng tōng xìn gōng sī
张阳|zhāng yáng
期出售手枪气枪猎|qī chū shòu shǒu qiāng qì qiāng liè
极端武力折刀|jí duān wǔ lì zhé dāo
蒙古回归|méng gǔ huí guī
陈一谘|chén yī zī
亲民党|qīn mín dǎng
賈慶林|jiǎ qìng lín
伊斯兰|yī sī lán
三唑侖|sān zuò lún
人权保护|rén quán bǎo hù
罗正富|luō zhèng fù
林左鸣|lín zuǒ míng
发愣|fā lèng
挫仑|cuò lún
红客联盟|hóng kè lián méng
李先念|lǐ xiān niàn
上分器|shàng fēn qì
出售54式手枪|chū shòu 54shì shǒu qiāng
政俯|zhèng fǔ
党后萎|dǎng hòu wēi
亚硝酰乙氧|yà xiāo xiān yǐ yǎng
欲仙欲死|yù xiān yù sǐ
枪的分|qiāng de fēn
纽扣摄像机|niǔ kòu shè xiàng jī
淫荡肛交妹自慰器|yín dàng gāng jiāo mèi zì wèi qì
世界十大独裁者|shì jiè shí dà dú cái zhě
燃烧弹制作|rán shāo dàn zhì zuò
炸药硝酸甘油制法|zhà yào xiāo suān gān yóu zhì fǎ
瘟家宝|wēn jiā bǎo
实毕业证|shí bì yè zhèng
雾型迷|wù xíng mí
简易炸弹|jiǎn yì zhà dàn
中共十八大前夕|zhōng gòng shí bā dà qián xī
fa轮|falún
令计划|lìng jì huá
弓弩制作|gōng nǔ zhì zuò
一通功|yī tōng gōng
强暴|qiáng bào
爆破|bào pò
进化不完全的生命体|jìn huà bù wán quán de shēng mìng tǐ
六合|liù hé
肛交|gāng jiāo
恐怖分子|kǒng bù fēn zǐ
IP17908|IP17908
徐建国|xú jiàn guó
骚嘴|sāo zuǐ
地产之歌|dì chǎn zhī gē
手枪|shǒu qiāng
陈德铭|chén dé míng
垡纶|fá lún
还看锦涛|huán kàn jǐn tāo
政一府|zhèng yī fǔ
地论坛|dì lùn tán
彩宝|cǎi bǎo
操你祖宗|cāo nǐ zǔ zōng
砍刀精品折刀专卖|kǎn dāo jīng pǐn zhé dāo zhuān mài
十大穷人|shí dà qióng rén
各类学术期刊征|gè lèi xué shù qī kān zhēng
范燕琼|fàn yàn qióng
贼民|zéi mín
人类灭亡进程表|rén lèi miè wáng jìn chéng biǎo
房峰辉|fáng fēng huī
指纹套|zhǐ wén tào
悔过书|huǐ guò shū
砝沦|fá lún
发国难财|fā guó nán cái
窃听器材|qiè tīng qì cái
迷昏口|mí hūn kǒu
逢八必灾|féng bā bì zāi
李宏治|lǐ hóng zhì
卖92手枪|mài 92shǒu qiāng
耶和华|yé hé huá
九评共产党|jiǔ píng gòng chǎn dǎng
柴玲|chái líng
防身药水|fáng shēn yào shuǐ
异见人士|yì jiàn rén shì
上床|shàng chuáng
偷欢|tōu huān
楼继伟|lóu jì wěi
吴镇南|wú zhèn nán
年的事|nián de shì
陆军部署|lù jūn bù shǔ
售一元硬|shòu yī yuán yìng
买春|mǎi chūn
记者无疆界|jì zhě wú jiāng jiè
无修正|wú xiū zhèng
亡党|wáng dǎng
找政府评理|zhǎo zhèng fǔ píng lǐ
救度众生说|jiù dù zhòng shēng shuō
世华商务|shì huá shāng wù
胡景涛|hú jǐng tāo
迷奸|mí jiān
王万宾|wáng wàn bīn
神7州行|shén 7zhōu xíng
春夏自由论坛|chūn xià zì yóu lùn tán
臺灣獨立|tái wān dú lì
插你|chā nǐ
各种发票|gè zhǒng fā piào
大红赤龙七头十角|dà hóng chì lóng qī tóu shí jiǎo
环球证件|huán qiú zhèng jiàn
自制炸药配方|zì zhì zhà yào pèi fāng
找男|zhǎo nán
六死|liù sǐ
诚信通手机商城|chéng xìn tōng shǒu jī shāng chéng
电话追杀系统|diàn huà zhuī shā xì tǒng
多人轮|duō rén lún
王学军|wáng xué jūn
装消音|zhuāng xiāo yīn
刘国凯|liú guó kǎi
明心|míng xīn
买枪|mǎi qiāng
叫晶晶的女孩|jiào jīng jīng de nǚ hái
刘延东|liú yán dōng
晴宜|qíng yí
李長春|lǐ cháng chūn
外交与方略|wài jiāo yǔ fāng lvè
一本道|yī běn dào
活摘器官|huó zhāi qì guān
军用刀具军品网|jūn yòng dāo jù jūn pǐn wǎng
十八大政治局|shí bā dà zhèng zhì jú
宇宙毁灭|yǔ zhòu huǐ miè
刘振亚|liú zhèn yà
事实独立|shì shí dú lì
钢珠弓弩专卖网|gāng zhū gōng nǔ zhuān mài wǎng
牟新生|móu xīn shēng
两会代|liǎng huì dài
做证件|zuò zhèng jiàn
实学历文|shí xué lì wén
快感|kuài gǎn
深圳红岭|shēn zhèn hóng líng
蔡继华|cài jì huá
李月鸟|lǐ yuè niǎo
胡jt|hú jt
陆浩|lù hào
作弊器|zuò bì qì
手机复制|shǒu jī fù zhì
保监会|bǎo jiān huì
麻醉药|má zuì yào
李洪X|lǐ hóng X
小泽玛莉亚|xiǎo zé mǎ lì yà
华企在线|huá qǐ zài xiàn
共党|gòng dǎng
钢珠枪小口径步枪|gāng zhū qiāng xiǎo kǒu jìng bù qiāng
黄菊遗孀|huáng jú yí shuāng
中国移动|zhōng guó yí dòng
十八大预测|shí bā dà yù cè
邢铮|xíng zhēng
胡绩伟|hú jī wěi
邓晓平|dèng xiǎo píng
发~票|fā ~piào
迪里夏提|dí lǐ xià tí
杨衍银|yáng yǎn yín
李玉妹|lǐ yù mèi
法西藏主义|fǎ xī cáng zhǔ yì
蔣彥永|jiǎng yàn yǒng
踩踏事故|cǎi tà shì gù
纯度白|chún dù bái
折刀砍刀军品网|zhé dāo kǎn dāo jūn pǐn wǎng
東京熱|dōng jīng rè
砲友|pào yǒu
古兰经|gǔ lán jīng
无帮国|wú bāng guó
社会主义|shè huì zhǔ yì
跨世纪的良心犯|kuà shì jì de liáng xīn fàn
江澤民.江八|jiāng zé mín .jiāng bā
肥逼|féi bī
倪育贤|ní yù xián
车仑工力|chē lún gōng lì
辛灏年|xīn hào nián
操嫂子|cāo sǎo zǐ
裹本|guǒ běn
代办真实文凭|dài bàn zhēn shí wén píng
实体娃|shí tǐ wá
成佛做主|chéng fó zuò zhǔ
投公|tóu gōng
甲基安非他明|jiǎ jī ān fēi tā míng
讨回工资|tǎo huí gōng zī
政f|zhèng f
武腾兰|wǔ téng lán
找个爸爸|zhǎo gè bà bà
黑社會|hēi shè huì
發票|fā piào
牌分析|pái fēn xī
枪械制|qiāng xiè zhì
深圳国领|shēn zhèn guó lǐng
匕首蝴蝶甩刀专卖|bǐ shǒu hú dié shuǎi dāo zhuān mài
导人最|dǎo rén zuì
党章|dǎng zhāng
折刀专卖网|zhé dāo zhuān mài wǎng
后勤集团|hòu qín jí tuán
丁一平|dīng yī píng
男公关|nán gōng guān
半刺刀|bàn cì dāo
福音会|fú yīn huì
西藏獨立|xī cáng dú lì
GONG党|GONGdǎng
论坛推广小助手|lùn tán tuī guǎng xiǎo zhù shǒu
共狗|gòng gǒu
学骚乱|xué sāo luàn
打折机票|dǎ zhé jī piào
Dajiyuan|Dajiyuan
民进党|mín jìn dǎng
务员答案|wù yuán dá àn
血腥图片|xiě xīng tú piàn
万润南|wàn rùn nán
鸡巴|jī bā
手机跟踪定位器|shǒu jī gēn zōng dìng wèi qì
門服務|mén fú wù
枪模|qiāng mó
姐服务|jiě fú wù
共产觉|gòng chǎn jué
地下刊物|dì xià kān wù
张文岳|zhāng wén yuè
国资委|guó zī wěi
宿命论|sù mìng lùn
业力轮|yè lì lún
有奶不一|yǒu nǎi bù yī
政论区|zhèng lùn qū
暗杀|àn shā
涛共产|tāo gòng chǎn
揭批书|jiē pī shū
里鹏|lǐ péng
黑索金的制造过程|hēi suǒ jīn de zhì zào guò chéng
马克思问|mǎ kè sī wèn
自制手枪哪里有卖|zì zhì shǒu qiāng nǎ lǐ yǒu mài
彭清华|péng qīng huá
燃烧弹 制作|rán shāo dàn  zhì zuò
KC网站|KCwǎng zhàn
买卖军用枪支|mǎi mài jūn yòng qiāng zhī
贝领|bèi lǐng
插进|chā jìn
促红细胞生成素|cù hóng xì bāo shēng chéng sù
保钓|bǎo diào
买肾|mǎi shèn
三班仆人派|sān bān pū rén pài
发贴机|fā tiē jī
六四|liù sì
探测狗|tàn cè gǒu
黄局|huáng jú
写的炸弹制作教程|xiě de zhà dàn zhì zuò jiào chéng
淫魔|yín mó
蒋文兰|jiǎng wén lán
火药|huǒ yào
张志清|zhāng zhì qīng
陈政高|chén zhèng gāo
灭亡中国|miè wáng zhōng guó
宏志|hóng zhì
民泽江|mín zé jiāng
闹独立|nào dú lì
首長|shǒu cháng
反人类|fǎn rén lèi
军刀专 卖|jūn dāo zhuān  mài
防身枪|fáng shēn qiāng
鸡毛信文汇|jī máo xìn wén huì
项怀诚|xiàng huái chéng
涿州|zhuō zhōu
2006年十句最真实的谎言|2006nián shí jù zuì zhēn shí de huǎng yán
火药原理|huǒ yào yuán lǐ
刘京|liú jīng
罢参|bà cān
金日成|jīn rì chéng
真、善、忍|zhēn 、shàn 、rěn
气枪购买|气枪组装|qì qiāng gòu mǎi |qì qiāng zǔ zhuāng
黑火药的配方|hēi huǒ yào de pèi fāng
盛雪辛灏年|shèng xuě xīn hào nián
抗日|kàng rì
激情妹|jī qíng mèi
中华联邦|zhōng huá lián bāng
殃视|yāng shì
黄慈萍|huáng cí píng
张开双腿|zhāng kāi shuāng tuǐ
现大地震|xiàn dà dì zhèn
淫魔舞|yín mó wǔ
制手枪|zhì shǒu qiāng
自慰|zì wèi
失身水|shī shēn shuǐ
吴仪|wú yí
地磅遥控器|dì bàng yáo kòng qì
售假币|shòu jiǎ bì
成都军区|chéng dū jūn qū
枪决女犯|qiāng jué nǚ fàn
车臣|chē chén
曾道人|céng dào rén
黑社会|hēi shè huì
吸精|xī jīng
王立军|wáng lì jūn
冰火毒|bīng huǒ dú
发表各类职称|fā biǎo gè lèi zhí chēng
亚砷（酸）酐|yà shēn （suān ）hàng
骚比|sāo bǐ
抽插|chōu chā
充气娃|chōng qì wá
酒瓶门|jiǔ píng mén
办文凭|bàn wén píng
淫兽|yín shòu
分裂中华人民共和国|fēn liè zhōng huá rén mín gòng hé guó
胡锦涛|hú jǐn tāo
反封锁技术|fǎn fēng suǒ jì shù
新闻总署态度蛮横|xīn wén zǒng shǔ tài dù mán héng
7个军区|7gè jūn qū
把邓小平|bǎ dèng xiǎo píng
姿不对死|zī bù duì sǐ
国研新闻邮件|guó yán xīn wén yóu jiàn
属灵教|shǔ líng jiào
台湾问题|tái wān wèn tí
马凯|mǎ kǎi
新党|xīn dǎng
淫妻|yín qī
中华养生益智功|zhōng huá yǎng shēng yì zhì gōng
裆中央|dāng zhōng yāng
金尧如|jīn yáo rú
六百度四|liù bǎi dù sì
朱海仑|zhū hǎi lún
大陆当局|dà lù dāng jú
联总|lián zǒng
援交|yuán jiāo
吴新雄|wú xīn xióng
插比|chā bǐ
换妻俱乐部|huàn qī jù lè bù
爆乳|bào rǔ
征兵计划|zhēng bīng jì huá
韶关旭|sháo guān xù
张又侠|zhāng yòu xiá
代写论|dài xiě lùn
爆草|bào cǎo
电话监|diàn huà jiān
法力像佛|fǎ lì xiàng fó
作硝化甘|zuò xiāo huà gān
E周刊|Ezhōu kān
自由时报|zì yóu shí bào
高幹|gāo gàn
大麻|dà má
罗礼诗|luō lǐ shī
关塔摩|guān tǎ mó
雪山狮子旗|xuě shān shī zǐ qí
湖淫娘|hú yín niáng
删除负面|shān chú fù miàn
风雨神州|fēng yǔ shén zhōu
手机监听|shǒu jī jiān tīng
和平请愿书|hé píng qǐng yuàn shū
售虎头|shòu hǔ tóu
舒淇|shū qí
术牌具|shù pái jù
案的准确|àn de zhǔn què
假币出售|jiǎ bì chū shòu
肉缝|ròu féng
少妇自拍|shǎo fù zì pāi
唐人电视台|táng rén diàn shì tái
7.31|7.31
贰拾年|èr shí nián
商务领航|shāng wù lǐng háng
布什|bù shén
李天羽|lǐ tiān yǔ
代办大学文凭|dài bàn dà xué wén píng
红智|hóng zhì
大纪园|dà jì yuán
傻B|shǎ B
植物冰|zhí wù bīng
讨厌中国|tǎo yàn zhōng guó
自慰用|zì wèi yòng
燃烧弹|rán shāo dàn
金振吉|jīn zhèn jí
王和民|wáng hé mín
潘云鹤|pān yún hè
张志国|zhāng zhì guó
售手枪|shòu shǒu qiāng
伦理大|lún lǐ dà
有偿肾|yǒu cháng shèn
气枪猎枪麻醉枪|qì qiāng liè qiāng má zuì qiāng
8945212|8945212
推翻专制独裁的共产党|tuī fān zhuān zhì dú cái de gòng chǎn dǎng
王喜斌|wáng xǐ bīn
中国没有自由|zhōng guó méi yǒu zì yóu
号|hào
军事社|jūn shì shè
枪支弹药|qiāng zhī dàn yào
行房|xíng fáng
海洛因|hǎi luò yīn
邢元敏|xíng yuán mǐn
口交|kǒu jiāo
红色恐怖|hóng sè kǒng bù
陈总统|chén zǒng tǒng
人在云上|rén zài yún shàng
回派|huí pài
美穴|měi xué
刘伟|liú wěi
中华帝国|zhōng huá dì guó
惩贪难|chéng tān nán
08宪|08xiàn
自由|zì yóu
屠杀学生|tú shā xué shēng
新建户|xīn jiàn hù
吗啡|ma fēi
藏毒|cáng dú
下体|xià tǐ
争鸣论坛|zhēng míng lùn tán
忍无可忍|rěn wú kě rěn
操你娘|cāo nǐ niáng
大降价|dà jiàng jià
自拍|zì pāi
张铁健|zhāng tiě jiàn
拟涛哥|nǐ tāo gē
王家瑞|wáng jiā ruì
李契克|lǐ qì kè
王秀丽|wáng xiù lì
各式气枪出售|gè shì qì qiāng chū shòu
孙忠同|sūn zhōng tóng
亦凡|yì fán
杀警|shā jǐng
筏纶|fá lún
第五代接班梯队|dì wǔ dài jiē bān tī duì
鲍彤|bào tóng
野营刀具专卖|yě yíng dāo jù zhuān mài
防卫甩棍出售|fáng wèi shuǎi gùn chū shòu
就爱插|jiù ài chā
阻止中华人民共和国统|zǔ zhǐ zhōng huá rén mín gòng hé guó tǒng
荭志|hóng zhì
爱滋|ài zī
肖亚庆|xiào yà qìng
弓弩图纸|gōng nǔ tú zhǐ
徐才厚|xú cái hòu
高武生|gāo wǔ shēng
直刀匕首直销网|zhí dāo bǐ shǒu zhí xiāo wǎng
张研农|zhāng yán nóng
恭喜你的号码|gōng xǐ nǐ de hào mǎ
党棍|dǎng gùn
中共封网|zhōng gòng fēng wǎng
代孕妈妈|dài yùn mā mā
贾安|jiǎ ān
康生丹|kāng shēng dān
门按摩|mén àn mó
大sb|dà sb
亚硒酸|yà xī suān
延安日记|yán ān rì jì
中共帮凶|zhōng gòng bāng xiōng
武警已增|wǔ jǐng yǐ zēng
期货配|qī huò pèi
江家帮|jiāng jiā bāng
颠覆中国政权|diān fù zhōng guó zhèng quán
陆四|lù sì
代生孩子|dài shēng hái zǐ
冤民大|yuān mín dà
为党不为国|wèi dǎng bù wèi guó
李宏志|lǐ hóng zhì
符强|fú qiáng
庭审直播|tíng shěn zhí bō
珐抡|fà lún
狂操|kuáng cāo
赵氏弓弩销售|zhào shì gōng nǔ xiāo shòu
女神教|nǚ shén jiào
y佳|yjiā
包夜|bāo yè
弓弩专卖|gōng nǔ zhuān mài
胡jintao|hú jintao
开天目|kāi tiān mù
弓弩|gōng nǔ
肏死|cào sǐ
毛泽东2|máo zé dōng 2
七大军区|qī dà jūn qū
理证件|lǐ zhèng jiàn
希葬|xī zàng
脱内裤|tuō nèi kù
明慧|míng huì
法X功|fǎ Xgōng
临震预报|lín zhèn yù bào
江氏|jiāng shì
都进中央|dū jìn zhōng yāng
乏论|fá lùn
轮暴|lún bào
金澤文子|jīn zé wén zǐ
法沦|fǎ lún
消业之说|xiāo yè zhī shuō
诸世纪|zhū shì jì
徐光春|xú guāng chūn
内争人权|nèi zhēng rén quán
淫照|yín zhào
漏乳|lòu rǔ
手工猎刀户外刀具|shǒu gōng liè dāo hù wài dāo jù
舔脚|tiǎn jiǎo
丝袜恋|sī wà liàn
主神教|zhǔ shén jiào
性伴侣|xìng bàn lǚ
抢购|qiǎng gòu
母奸|mǔ jiān
鞑子|dá zǐ
信访专班|xìn fǎng zhuān bān
弓弩营销中心|gōng nǔ yíng xiāo zhōng xīn
猎枪出售/枪|liè qiāng chū shòu /qiāng
群起抗暴|qún qǐ kàng bào
佛展千手法|fó zhǎn qiān shǒu fǎ
周正毅|zhōu zhèng yì
工商税务两条狼|gōng shāng shuì wù liǎng tiáo láng
带考|dài kǎo
神韵艺术|shén yùn yì shù
共青背景|gòng qīng bèi jǐng
供应钢珠弓弩|gōng yìng gāng zhū gōng nǔ
出售雷管|chū shòu léi guǎn
李延芝|lǐ yán zhī
成人卡通|chéng rén qiǎ tōng
突破网路|tū pò wǎng lù
9ping|9ping
瘟加饱|wēn jiā bǎo
华岳时事论坛|huá yuè shí shì lùn tán
杜智富|dù zhì fù
无网界|wú wǎng jiè
气枪迷魂药|qì qiāng mí hún yào
泓志|hóng zhì
法谪|fǎ zhé
淫荡迷情药|yín dàng mí qíng yào
子女任职名单|zǐ nǚ rèn zhí míng dān
帮穷人|bāng qióng rén
猛男|měng nán
短信广告|duǎn xìn guǎng gào
陈奎元|chén kuí yuán
俄罗斯|é luō sī
辛灝年|xīn hào nián
鲍戈|bào gē
新疆暴乱|xīn jiāng bào luàn
摸奶|mō nǎi
阴道|yīn dào
h动画|hdòng huà
中央团系|zhōng yāng tuán xì
北美自由论坛|běi měi zì yóu lùn tán
报复执法|bào fù zhí fǎ
夺权|duó quán
张云川|zhāng yún chuān
尹方明|yǐn fāng míng
俞正声|yú zhèng shēng
出售猎枪 电话|chū shòu liè qiāng  diàn huà
法抡|fǎ lún
民阵|mín zhèn
手变牌|shǒu biàn pái
淪攻|lún gōng
亚硒酸钠|yà xī suān nà
清海师父|qīng hǎi shī fù
中华大地思考|zhōng huá dà dì sī kǎo
李长江|lǐ cháng jiāng
乏伦|fá lún
摩小姐|mó xiǎo jiě
迷魂香|mí hún xiāng
核弹制作方法|hé dàn zhì zuò fāng fǎ
人大|rén dà
李登辉|lǐ dēng huī
冰火漫|bīng huǒ màn
何德普|hé dé pǔ
攻官小姐|gōng guān xiǎo jiě
了件渔袍|le jiàn yú páo
两个中国|liǎng gè zhōng guó
五毛们|wǔ máo men
湾版假|wān bǎn jiǎ
鲜族|xiān zú
记号扑克|jì hào pū kè
飯島愛|fàn dǎo ài
刘志军|liú zhì jūn
原子弹制作 方法|yuán zǐ dàn zhì zuò  fāng fǎ
大雞巴|dà jī bā
急聘兼职打字|jí pìn jiān zhí dǎ zì
姓忽悠|xìng hū yōu
di制|dizhì
摩门教|mó mén jiào
次通过考|cì tōng guò kǎo
妹按摩|mèi àn mó
广 闻|guǎng  wén
死全家|sǐ quán jiā
指纹膜|zhǐ wén mò
冷钢刀具军品网|lěng gāng dāo jù jūn pǐn wǎng
绝食声|jué shí shēng
jiangdongriji|jiangdongriji
上门激|shàng mén jī
64惨案|64cǎn àn
古方迷香|gǔ fāng mí xiāng
台毒|tái dú
家属被打|jiā shǔ bèi dǎ
莫洛托夫鸡尾酒的配方|mò luò tuō fū jī wěi jiǔ de pèi fāng
美逼|měi bī
世界经济导报|shì jiè jīng jì dǎo bào
18权力布局|18quán lì bù jú
平近习|píng jìn xí
蓝光|lán guāng
打死人|dǎ sǐ rén
北美讲坛|běi měi jiǎng tán
李铁映|lǐ tiě yìng
定位器|dìng wèi qì
游戏机上分定位器|yóu xì jī shàng fēn dìng wèi qì
围攻上海|wéi gōng shàng hǎi
自已的故事|zì yǐ de gù shì
张连珍|zhāng lián zhēn
两岸才子|liǎng àn cái zǐ
路甬祥|lù yǒng xiáng
六河蟹四|liù hé xiè sì
卢展工|lú zhǎn gōng
李树菲|lǐ shù fēi
工字牌气枪出售专卖|gōng zì pái qì qiāng chū shòu zhuān mài
崩盘|bēng pán
西脏|xī zāng
4．25事件|4．25shì jiàn
十大独裁|shí dà dú cái
第五代领导|dì wǔ dài lǐng dǎo
炸弹制作从入门|zhà dàn zhì zuò cóng rù mén
杀指南|shā zhǐ nán
威胁论|wēi xié lùn
清海无上师|qīng hǎi wú shàng shī
18大委员名单|18dà wěi yuán míng dān
元极功|yuán jí gōng
军刺野营砍刀出售|jūn cì yě yíng kǎn dāo chū shòu
要射了|yào shè le
四博会|sì bó huì
戴海静|dài hǎi jìng
张小平|zhāng xiǎo píng
陈子明|chén zǐ míng
工产党|gōng chǎn dǎng
售猎枪|shòu liè qiāng
赤匪|chì fěi
纪念文革|jì niàn wén gé
国民根本大法|guó mín gēn běn dà fǎ
中共十八布局|zhōng gòng shí bā bù jú
弓弩专卖网货到付款|gōng nǔ zhuān mài wǎng huò dào fù kuǎn
姬胜德|jī shèng dé
弟疼|dì téng
安局豪华|ān jú háo huá
zha弹|zhadàn
睾丸|gāo wán
防卫著名军刀出售|fáng wèi zhù míng jūn dāo chū shòu
粟戎生|sù róng shēng
氓培训|máng péi xùn
藏独|cáng dú
猫则东|māo zé dōng
莫达非尼|mò dá fēi ní
张宏堡|zhāng hóng bǎo
C4炸药的成分|C4zhà yào de chéng fēn
手拉鸡|shǒu lā jī
插屁屁|chā pì pì
许其亮|xǔ qí liàng
共贼|gòng zéi
吕京花|lǚ jīng huā
习晋平|xí jìn píng
游龙商务联盟|yóu lóng shāng wù lián méng
中国孤儿院|zhōng guó gū ér yuàn
第五代领导人|dì wǔ dài lǐng dǎo rén
代您考|dài nín kǎo
张昭富|zhāng zhāo fù
杨树宽|yáng shù kuān
郑州弓弩专卖|zhèng zhōu gōng nǔ zhuān mài
弹种|dàn zhǒng
姜建清|jiāng jiàn qīng
透视麻将|tòu shì má jiāng
書記|shū jì
黑火药配方比例|hēi huǒ yào pèi fāng bǐ lì
午夜极|wǔ yè jí
徐斌|xú bīn
贺立旗|hè lì qí
阀纶|fá lún
高性能爆炸物质混合|gāo xìng néng bào zhà wù zhí hùn hé
最牛公安|zuì niú gōng ān
侦探设备|zhēn tàn shè bèi
汕尾|shàn wěi
五不|wǔ bù
金鳞岂是池中物|jīn lín qǐ shì chí zhōng wù
台海统一|tái hǎi tǒng yī
愚民同|yú mín tóng
出售弹簧刀|chū shòu dàn huáng dāo
挡中央|dǎng zhōng yāng
王三运|wáng sān yùn
考前付|kǎo qián fù
暴亂|bào luàn
全集在线|quán jí zài xiàn
制服|zhì fú
足球网上娱乐|zú qiú wǎng shàng yú lè
各个银行全称|gè gè yín xíng quán chēng
国一九五七|guó yī jiǔ wǔ qī
联通贵宾卡|lián tōng guì bīn qiǎ
益关注组|yì guān zhù zǔ
大波|dà bō
两岸战争|liǎng àn zhàn zhēng
汽油三分之一白糖混合|qì yóu sān fēn zhī yī bái táng hùn hé
蒙汗药|méng hàn yào
暴乱|bào luàn
河蟹社会|hé xiè shè huì
熟妇|shú fù
筏抡|fá lún
被中共|bèi zhōng gòng
激情炮|jī qíng pào
轮法功|lún fǎ gōng
王宝森|wáng bǎo sēn
红志|hóng zhì
拉萨|lā sà
瘸腿帮|qué tuǐ bāng
法一轮|fǎ yī lún
汽枪|qì qiāng
催情药|cuī qíng yào
力月西|lì yuè xī
苏士亮|sū shì liàng
小逼|xiǎo bī
免电灯|miǎn diàn dēng
胡紧掏|hú jǐn tāo
打倒中国|dǎ dǎo zhōng guó
支那猪|zhī nà zhū
两岸关系|liǎng àn guān xì
川島和津實|chuān dǎo hé jīn shí
京夫子|jīng fū zǐ
陈文清|chén wén qīng
一黨|yī dǎng
淫情女|yín qíng nǚ
新疆独|xīn jiāng dú
未来的自由中国在民间|wèi lái de zì yóu zhōng guó zài mín jiān
打死经过|dǎ sǐ jīng guò
拉萨僧人接连抗议|lā sà sēng rén jiē lián kàng yì
成人仿真抽插|chéng rén fǎng zhēn chōu chā
中华真实报道|zhōng huá zhēn shí bào dào
沙比|shā bǐ
北美巡回讲法|běi měi xún huí jiǎng fǎ
踩江|cǎi jiāng
韶关玩|sháo guān wán
共残党|gòng cán dǎng
联合起诉最高人民法院|lián hé qǐ sù zuì gāo rén mín fǎ yuàn
推bei图|tuī beitú
庭保养|tíng bǎo yǎng
原一九五七|yuán yī jiǔ wǔ qī
陰戶|yīn hù
刘晓榕|liú xiǎo róng
解决台湾|jiě jué tái wān
手机窃听器|shǒu jī qiè tīng qì
证到付款|zhèng dào fù kuǎn
谢和平|xiè hé píng
蝶舞按|dié wǔ àn
198964|198964
年福纯|nián fú chún
吕秀莲|lǚ xiù lián
75事件|75shì jiàn
多美康|duō měi kāng
热站政论网|rè zhàn zhèng lùn wǎng
手槍|shǒu qiāng
兽交|shòu jiāo
伪基百科|wěi jī bǎi kē
王洪章|wáng hóng zhāng
gong党|gongdǎng
集团出售手枪|jí tuán chū shòu shǒu qiāng
KC嘉年华|KCjiā nián huá
生踩踏|shēng cǎi tà
揉乳|róu rǔ
多党执政|duō dǎng zhí zhèng
党中央|dǎng zhōng yāng
唐家璇|táng jiā xuán
gc党|gcdǎng
四川独|sì chuān dú
马强|mǎ qiáng
电脑传讯|diàn nǎo chuán xùn
陈炳德|chén bǐng dé
罢餐|bà cān
达米宣教会|dá mǐ xuān jiào huì
李崇禧|lǐ chóng xǐ
清zhen|qīng zhen
回民猪|huí mín zhū
傻比|shǎ bǐ
分裂中国|fēn liè zhōng guó
偷電器|tōu diàn qì
貓肉|māo ròu
王儒林|wáng rú lín
熟母|shú mǔ
海外民运|hǎi wài mín yùn
李peng|lǐ peng
王超华|wáng chāo huá
坐交|zuò jiāo
风雨神州论坛|fēng yǔ shén zhōu lùn tán
军刀电棍销售|jūn dāo diàn gùn xiāo shòu
林文漪|lín wén yī
东突|dōng tū
罗志军|luō zhì jūn
时事论坛|shí shì lùn tán
税务总局致歉|shuì wù zǒng jú zhì qiàn
杨元元|yáng yuán yuán
毛相|máo xiāng
一码|yī mǎ
帮忙点一下|bāng máng diǎn yī xià
杜学芳|dù xué fāng
游戏机破解|yóu xì jī pò jiě
恐共|kǒng gòng
发正念|fā zhèng niàn
台海大战|tái hǎi dà zhàn
我搞台独|wǒ gǎo tái dú
弓弩麻醉镖|gōng nǔ má zuì biāo
砝伦|fá lún
解放军|jiě fàng jūn
魏京生|wèi jīng shēng
天灭中共|tiān miè zhōng gòng
9学|9xué
销售电手狗|xiāo shòu diàn shǒu gǒu
锦涛|jǐn tāo
3退|3tuì
外蒙回归|wài méng huí guī
手机游戏|shǒu jī yóu xì
配有消|pèi yǒu xiāo
性感诱惑|xìng gǎn yòu huò
曹长青|cáo cháng qīng
商圈|shāng quān
嫩阴|nèn yīn
伊皮恩|yī pí ēn
蛤蟆转世|há má zhuǎn shì
昨日重现|zuó rì zhòng xiàn
翟小衡|zhái xiǎo héng
紅志|hóng zhì
黄翔|huáng xiáng
刘少奇|liú shǎo qí
免费电影|miǎn fèi diàn yǐng
选国家主席|xuǎn guó jiā zhǔ xí
发伦功|fā lún gōng
中国实行血腥教育|zhōng guó shí xíng xiě xīng jiào yù
星上门|xīng shàng mén
淫荡|yín dàng
狼全部跪|láng quán bù guì
赚钱资料|zhuàn qián zī liào
百家乐|bǎi jiā lè
台湾国|tái wān guó
沈素琍|shěn sù lì
胡派|hú pài
臧独|zāng dú
汤光中|tāng guāng zhōng
中南海斗争|zhōng nán hǎi dǒu zhēng
法lg|fǎ lg
上海帮|shàng hǎi bāng
姐兼职|jiě jiān zhí
方励之|fāng lì zhī
淫虐|yín nuè
中俄密约|zhōng é mì yuē
绵恒异议人士|mián héng yì yì rén shì
胡总书记|hú zǒng shū jì
谢中之|xiè zhōng zhī
硝酸甘油制作|xiāo suān gān yóu zhì zuò
懊运|ào yùn
传九促三|chuán jiǔ cù sān
猎枪|真枪|liè qiāng |zhēn qiāng
gay片|gaypiàn
打飞机专|dǎ fēi jī zhuān
速取证|sù qǔ zhèng
恭喜您的号码|gōng xǐ nín de hào mǎ
江派|jiāng pài
徐玉元|xú yù yuán
奇淫散|qí yín sàn
申维辰|shēn wéi chén
腾讯客服电话|téng xùn kè fú diàn huà
色情服务|sè qíng fú wù
江泽民.江贼|jiāng zé mín .jiāng zéi
偷肃贪|tōu sù tān
制服诱|zhì fú yòu
冰淫传|bīng yín chuán
双臀|shuāng tún
李长春|lǐ cháng chūn
两岸三地论坛|liǎng àn sān dì lùn tán
政治局委员增加一倍|zhèng zhì jú wěi yuán zēng jiā yī bèi
钱三字经|qián sān zì jīng
口活|kǒu huó
佛同修|fó tóng xiū
炸弹制作|zhà dàn zhì zuò
天皇|tiān huáng
文革|wén gé
人quan|rén quan
李金章|lǐ jīn zhāng
六四内部日记|liù sì nèi bù rì jì
十七位老部长|shí qī wèi lǎo bù cháng
阳江刀具直销网|yáng jiāng dāo jù zhí xiāo wǎng
情视频|qíng shì pín
写两会|xiě liǎng huì
色界|sè jiè
圣战组织|shèng zhàn zǔ zhī
栗智|lì zhì
震惊全球|zhèn jīng quán qiú
田成平|tián chéng píng
硝化甘|xiāo huà gān
强效失忆药|qiáng xiào shī yì yào
大史纪|dà shǐ jì
住英国房|zhù yīng guó fáng
人事接班|rén shì jiē bān
哪里有枪出售|nǎ lǐ yǒu qiāng chū shòu
叶子楣|yè zǐ méi
国务院|guó wù yuàn
罚抡|fá lún
阴间来电|yīn jiān lái diàn
連發|lián fā
性技巧|xìng jì qiǎo
淫肉|yín ròu
珐轮|fà lún
小额贷款|xiǎo é dài kuǎn
香港明报|xiāng gǎng míng bào
高就在政|gāo jiù zài zhèng
提供气狗专卖店|tí gōng qì gǒu zhuān mài diàn
法淪|fǎ lún
邓昌友|dèng chāng yǒu
请示威|qǐng shì wēi
江沢民|jiāng zé mín
阿賓|ā bīn
薄熙来|bó xī lái
反攻|fǎn gōng
renmingbao|renmingbao
供应军用弓弩专卖|gōng yìng jūn yòng gōng nǔ zhuān mài
贷开|dài kāi
宋平顺|sòng píng shùn
考前答案|kǎo qián dá àn
业力回报|yè lì huí bào
台湾自由联盟|tái wān zì yóu lián méng
尸博|shī bó
优化官员|yōu huà guān yuán
20和谐年|20hé xié nián
炸弹制作入门|zhà dàn zhì zuò rù mén
共军|gòng jūn
一党专政|yī dǎng zhuān zhèng
罗箭|luō jiàn
蔡赴朝|cài fù zhāo
卫生部|wèi shēng bù
八九|bā jiǔ
人真钱|rén zhēn qián
朝鲁|zhāo lǔ
胡x|hú x
袁贵仁|yuán guì rén
一夜情|yī yè qíng
邓xp|dèng xp
六四受难者家属证辞|liù sì shòu nán zhě jiā shǔ zhèng cí
出售手枪=货到付款|chū shòu shǒu qiāng =huò dào fù kuǎn
砍伤儿|kǎn shāng ér
朱镕鸡|zhū róng jī
炸弹制作从入门到精|zhà dàn zhì zuò cóng rù mén dào jīng
谜奸药|mí jiān yào
马宏林|mǎ hóng lín
胡錦濤|hú jǐn tāo
喝一送一|hē yī sòng yī
弓弩商城专卖|gōng nǔ shāng chéng zhuān mài
李瑞環|lǐ ruì huán
唐捷|táng jié
静zuo|jìng zuo
佳静安定片|jiā jìng ān dìng piàn
明镜出版社|míng jìng chū bǎn shè
暴菊|bào jú
新搪人|xīn táng rén
钢珠枪|gāng zhū qiāng
复转军人|fù zhuǎn jūn rén
防卫棍刀出售|fáng wèi gùn dāo chū shòu
法L功|fǎ Lgōng
卖银行卡|mài yín xíng qiǎ
陈希|chén xī
红蜘蛛迷奸药|hóng zhī zhū mí jiān yào
燃烧弹的制作方|rán shāo dàn de zhì zuò fāng
李沛瑶|lǐ pèi yáo
乱伦|luàn lún
全哲洙|quán zhé zhū
电警棒|diàn jǐng bàng
左翼联盟|zuǒ yì lián méng
服务托管租用|fú wù tuō guǎn zū yòng
黑火药的|hēi huǒ yào de
大法弟子|dà fǎ dì zǐ
日烂|rì làn
中央领导|zhōng yāng lǐng dǎo
江zm|jiāng zm
性感少|xìng gǎn shǎo
最后圆满|zuì hòu yuán mǎn
拉线飞机|lā xiàn fēi jī
毛泽东|máo zé dōng
虹志|hóng zhì
禁看|jìn kàn
美沙酮|měi shā tóng
谁为腐败晚餐买单|shuí wèi fǔ bài wǎn cān mǎi dān
档中央|dǎng zhōng yāng
逊克农场26队|xùn kè nóng cháng 26duì
发轮功|fā lún gōng
洞小口紧|dòng xiǎo kǒu jǐn
胡玉敏|hú yù mǐn
裸露|luǒ lù
大法|dà fǎ
一夜欢|yī yè huān
手枪气* 枪猎|shǒu qiāng qì * qiāng liè
增值税|zēng zhí shuì
女技师|nǚ jì shī
好嫩|hǎo nèn
马勒|mǎ lè
着涛哥|zháo tāo gē
反日|fǎn rì
末世劫难|mò shì jié nán
姜伟新|jiāng wěi xīn
雅思|yǎ sī
汽狗|qì gǒu
枪支|qiāng zhī
报码|bào mǎ
破解|pò jiě
制作证件|zhì zuò zhèng jiàn
弓弩论坛|gōng nǔ lùn tán
打倒|dǎ dǎo
吴邦国|wú bāng guó
两会又三|liǎng huì yòu sān
人流|rén liú
欲女|yù nǚ
陈至|chén zhì
草你丫|cǎo nǐ yā
灭中共|miè zhōng gòng
贾庆|jiǎ qìng
驶你老母|shǐ nǐ lǎo mǔ
基督|jī dū
打狗弓弩三步倒|dǎ gǒu gōng nǔ sān bù dǎo
2004年公共服务奖|2004nián gōng gòng fú wù jiǎng
陈左宁|chén zuǒ níng
华建敏|huá jiàn mǐn
江core|jiāng core
美女|měi nǚ
影子政府|yǐng zǐ zhèng fǔ
出成绩付|chū chéng jī fù
二奶大|èr nǎi dà
法仑功|fǎ lún gōng
抢粮记|qiǎng liáng jì
耀邦|yào bāng
宋秀岩|sòng xiù yán
别他吗|bié tā ma
猎枪哪里有卖|liè qiāng nǎ lǐ yǒu mài
第五代领导新星|dì wǔ dài lǐng dǎo xīn xīng
办理文凭|bàn lǐ wén píng
台獨|tái dú
十八换血|shí bā huàn xiě
缩阴|suō yīn
积克馆|jī kè guǎn
陈军|chén jūn
隐蔽式摄像机|yǐn bì shì shè xiàng jī
何祚庥|hé zuò xiū
龙虎豹|lóng hǔ bào
杨佳|yáng jiā
雍战胜|yōng zhàn shèng
罚纶|fá lún
哪里有卖双管猎|nǎ lǐ yǒu mài shuāng guǎn liè
论文代|lùn wén dài
美臀夹阴|měi tún jiā yīn
两会|liǎng huì
销售/专卖/买卖77式手枪|xiāo shòu /zhuān mài /mǎi mài 77shì shǒu qiāng
大鸡巴|dà jī bā
李志绥|lǐ zhì suī
择油录|zé yóu lù
法院给废|fǎ yuàn gěi fèi
正邪大决战|zhèng xié dà jué zhàn
狩猎弓弩麻醉箭|shòu liè gōng nǔ má zuì jiàn
刘俊国|liú jùn guó
娘两腿之间|niáng liǎng tuǐ zhī jiān
郑恩宠|zhèng ēn chǒng
复印件制|fù yìn jiàn zhì
孙建国|sūn jiàn guó
蟾蜍迁徙|chán chú qiān xǐ
揭贪难|jiē tān nán
无界网络|wú jiè wǎng luò
乱奸|luàn jiān
台盟|tái méng
神七假|shén qī jiǎ
打炮|dǎ pào
四级答案|sì jí dá àn
迷情粉|mí qíng fěn
津人治津|jīn rén zhì jīn
冰火九重|bīng huǒ jiǔ zhòng
中共派系力量再达成妥协|zhōng gòng pài xì lì liàng zài dá chéng tuǒ xié
炸立交|zhà lì jiāo
激情视频|jī qíng shì pín
赵爱明|zhào ài míng
江嫡系|jiāng dí xì
胡派军委|hú pài jūn wěi
银氰化钾|yín qīng huà jiǎ
原砷酸|yuán shēn suān
龙新民|lóng xīn mín
口手枪|kǒu shǒu qiāng
龙小霞|lóng xiǎo xiá
售火药|shòu huǒ yào
波胆|bō dǎn
司长期有|sī cháng qī yǒu
胡书记|hú shū jì
董存瑞问|dǒng cún ruì wèn
成人电影|chéng rén diàn yǐng
钓鱼台|diào yú tái
售左轮|shòu zuǒ lún
嫖妓|piào jì
李适时|lǐ shì shí
权贵集团|quán guì jí tuán
山涉黑|shān shè hēi
邱学强|qiū xué qiáng
反共言论|fǎn gòng yán lùn
陈元|chén yuán
杨传升|yáng chuán shēng
兼职上门|jiān zhí shàng mén
复印件生|fù yìn jiàn shēng
办怔|bàn zhēng
大圆满法|dà yuán mǎn fǎ
洗脑|xǐ nǎo
出现暴动|chū xiàn bào dòng
王伟光|wáng wěi guāng
尼泊尔军刀出售|ní bó ěr jūn dāo chū shòu
骚浪|sāo làng
台湾应该独立|tái wān yìng gāi dú lì
文做|wén zuò
杨巍|yáng wēi
共X党|gòng Xdǎng
强卫|qiáng wèi
手枪式折叠三用弩|shǒu qiāng shì zhé dié sān yòng nǔ
田力普|tián lì pǔ
石宗源|shí zōng yuán
韵徐娘|yùn xú niáng
38集团军|38jí tuán jūn
六HE彩|liù HEcǎi
甲睾酮|jiǎ gāo tóng
靖国神社|jìng guó shén shè
党退|dǎng tuì
杜恒岩|dù héng yán
针孔摄像机|zhēn kǒng shè xiàng jī
黑火药配方|hēi huǒ yào pèi fāng
南联盟|nán lián méng
谢旭人|xiè xù rén
砍杀幼|kǎn shā yòu
由喜贵|yóu xǐ guì
法 轮 功|fǎ  lún  gōng
京要地震|jīng yào dì zhèn
老毛子|lǎo máo zǐ
特惠房|tè huì fáng
度假区|dù jiǎ qū
伐轮|fá lún
力骗中央|lì piàn zhōng yāng
毛一鲜|máo yī xiān
泡沫经济|pào mò jīng jì
裸舞视|luǒ wǔ shì
政权|zhèng quán
将则民|jiāng zé mín
首长|shǒu cháng
罢ke|bà ke
大批贪官|dà pī tān guān
丝护士|sī hù shì
苏贞昌|sū zhēn chāng
气枪联系QQ|qì qiāng lián xì QQ
小型弓弩专卖店|xiǎo xíng gōng nǔ zhuān mài diàn
监狱管理局|jiān yù guǎn lǐ jú
徐邦秦|xú bāng qín
出售军品军刀|chū shòu jūn pǐn jūn dāo
激情电|jī qíng diàn
腐敗|fǔ bài
氣槍|qì qiāng
军刀匕首直销网|jūn dāo bǐ shǒu zhí xiāo wǎng
空中民主墙|kōng zhōng mín zhǔ qiáng
连锁加盟|lián suǒ jiā méng
雷人女官|léi rén nǚ guān
阿扁推翻|ā biǎn tuī fān
中国贪官在海外|zhōng guó tān guān zài hǎi wài
恩氟烷|ēn fú wán
精液|jīng yè
自由西藏学生运动|zì yóu xī cáng xué shēng yùn dòng
出售美军现役军刀|chū shòu měi jūn xiàn yì jūn dāo
原藜芦碱A|yuán lí lú jiǎn A
弓弩专卖货到付款|gōng nǔ zhuān mài huò dào fù kuǎn
麻醉乙醚|má zuì yǐ mí
走私车|zǒu sī chē
嫩女|nèn nǚ
王军涛|wáng jūn tāo
供应弩用麻醉箭|gōng yìng nǔ yòng má zuì jiàn
徐守|xú shǒu
税力|shuì lì
民运人士|mín yùn rén shì
恐怖分子自己制造炸弹|kǒng bù fēn zǐ zì jǐ zhì zào zhà dàn
皇家轮盘|huáng jiā lún pán
逢8必灾|féng 8bì zāi
专业调查|zhuān yè diào chá
鸟巢最少死|niǎo cháo zuì shǎo sǐ
是躲猫|shì duǒ māo
杨崇汇|yáng chóng huì
李 洪 志|lǐ  hóng  zhì
利他林|lì tā lín
追债公司|zhuī zhài gōng sī
三利达弓弩军刀|sān lì dá gōng nǔ jūn dāo
留四进三|liú sì jìn sān
居住证办理|jū zhù zhèng bàn lǐ
禽流感了|qín liú gǎn le
保过|bǎo guò
四联航空|sì lián háng kōng
西藏国家民主党|xī cáng guó jiā mín zhǔ dǎng
瞒报|mán bào
登辉|dēng huī
搞媛交|gǎo yuàn jiāo
姐疼|jiě téng
中国不强|zhōng guó bù qiáng
东伊运|dōng yī yùn
淫样|yín yáng
蒙汗药粉|méng hàn yào fěn
荡妇|dàng fù
西葬|xī zàng
卖肾|mài shèn
一小撮别|yī xiǎo cuō bié
生被砍|shēng bèi kǎn
超越红墙|chāo yuè hóng qiáng
邓朴方|dèng pǔ fāng
赵晓微|zhào xiǎo wēi
强制拆除|qiáng zhì chāi chú
乱交|luàn jiāo
猎枪销|liè qiāng xiāo
出售三棱刀|chū shòu sān léng dāo
三步倒药箭批发|sān bù dǎo yào jiàn pī fā
脏毒|zāng dú
共黨|gòng dǎng
张裔炯|zhāng yì jiǒng
手木仓|shǒu mù cāng
政zhi|zhèng zhi
世界之门|shì jiè zhī mén
莫伟强|mò wěi qiáng
人民之声论坛|rén mín zhī shēng lùn tán
仆不怕饮|pū bù pà yǐn
乙醚|yǐ mí
考试作弊|kǎo shì zuò bì
法x功|fǎ xgōng
三步倒捕狗药|sān bù dǎo bǔ gǒu yào
派系斗争|pài xì dǒu zhēng
西藏作家组织|xī cáng zuò jiā zǔ zhī
狩猎器材弓弩专卖|shòu liè qì cái gōng nǔ zhuān mài
蓝丝带|lán sī dài
8023部队|8023bù duì
骆惠宁|luò huì níng
张立昌|zhāng lì chāng
胡江争斗|hú jiāng zhēng dǒu
被插|bèi chā
新唐人|xīn táng rén
罗清泉|luō qīng quán
谁是新中国|shuí shì xīn zhōng guó
中华昆仑女神功|zhōng huá kūn lún nǚ shén gōng
春夏之交|chūn xià zhī jiāo
军刀网|jūn dāo wǎng
伐囵|fá lún
弓弩销售|gōng nǔ xiāo shòu
肾源|shèn yuán
席复活|xí fù huó
防卫野营砍刀出售|fáng wèi yě yíng kǎn dāo chū shòu
18届名单|18jiè míng dān
王岐山|wáng qí shān
小姐|xiao jie
